Day,Market Participant,Equity Option Contracts,Equity Option Trade Count,Equity Option Notional,Index/Other Option Contracts,Index/Other Option Trade Count,Index/Other Option Notional,Total Option Contracts,Total Trade Count,Total Option Notional
2023-07-21,NYSE American Options (A),3058232,262542,834917270.000000,0,0,0.000000,3058232,262542,834917270.000000
2023-07-21,BOX Options (B),2873717,349203,686072915.000000,0,0,0.000000,2873717,349203,686072915.000000
2023-07-21,Cboe Options Exchange (C),4810666,673781,1215577373.000000,3138540,535770,6704555500.000000,7949206,1209551,7920132873.000000
2023-07-21,MIAX Emerald (D),1249293,219984,304315551.000000,0,0,0.000000,1249293,219984,304315551.000000
2023-07-21,Cboe EDGX Options Exchange (E),2565828,381570,469333414.000000,0,0,0.000000,2565828,381570,469333414.000000
2023-07-21,Nasdaq GEMX (H),1385980,190228,252937560.000000,4775,1465,105690718.000000,1390755,191693,358628278.000000
2023-07-21,Nasdaq ISE (I),2881899,345921,990270037.000000,14406,5246,149743202.000000,2896305,351167,1140013239.000000
2023-07-21,Nasdaq MRX (J),949431,130112,193427724.000000,0,0,0.000000,949431,130112,193427724.000000
2023-07-21,MIAX Options Exchange (M),2699741,422333,672915957.000000,0,0,0.000000,2699741,422333,672915957.000000
2023-07-21,NYSE Arca Options (N),4907588,684587,1273115907.000000,0,0,0.000000,4907588,684587,1273115907.000000
2023-07-21,MIAX Pearl (P),2740811,312375,503241207.000000,0,0,0.000000,2740811,312375,503241207.000000
2023-07-21,NASDAQ Options Market (Q),2587856,421410,665487658.000000,0,0,0.000000,2587856,421410,665487658.000000
2023-07-21,Nasdaq BX Options (T),1942550,306241,659138719.000000,0,0,0.000000,1942550,306241,659138719.000000
2023-07-21,Cboe C2 Options Exchange (W),1924531,244586,315834443.000000,12404,3553,23550263.000000,1936935,248139,339384706.000000
2023-07-21,Nasdaq PHLX (X),4293992,325551,1164129061.000000,16280,6545,233100215.000000,4310272,332096,1397229276.000000
2023-07-21,Cboe BZX Options Exchange (Z),2319949,326579,523265044.000000,3806,1012,13168623.000000,2323755,327591,536433667.000000
2023-07-20,NYSE American Options (A),2963077,286042,763030798.000000,0,0,0.000000,2963077,286042,763030798.000000
2023-07-20,BOX Options (B),2785814,367441,1025097469.000000,0,0,0.000000,2785814,367441,1025097469.000000
2023-07-20,Cboe Options Exchange (C),5280472,705286,1424954704.000000,3885468,577777,6614929240.000000,9165940,1283063,8039883944.000000
2023-07-20,MIAX Emerald (D),1347171,237081,369722318.000000,0,0,0.000000,1347171,237081,369722318.000000
2023-07-20,Cboe EDGX Options Exchange (E),2725212,401408,553649612.000000,0,0,0.000000,2725212,401408,553649612.000000
2023-07-20,Nasdaq GEMX (H),1494745,207395,310592537.000000,3098,1044,75962647.000000,1497843,208439,386555184.000000
2023-07-20,Nasdaq ISE (I),2824146,340805,1054688143.000000,39990,13414,235426329.000000,2864136,354219,1290114472.000000
2023-07-20,Nasdaq MRX (J),960414,139303,218908891.000000,0,0,0.000000,960414,139303,218908891.000000
2023-07-20,MIAX Options Exchange (M),2885061,461751,740855577.000000,8,8,81195.000000,2885069,461759,740936772.000000
2023-07-20,NYSE Arca Options (N),5366466,725858,1527717152.000000,0,0,0.000000,5366466,725858,1527717152.000000
2023-07-20,MIAX Pearl (P),2955324,336673,583333412.000000,0,0,0.000000,2955324,336673,583333412.000000
2023-07-20,NASDAQ Options Market (Q),2542980,415649,700626900.000000,0,0,0.000000,2542980,415649,700626900.000000
2023-07-20,Nasdaq BX Options (T),2194419,315761,514770889.000000,0,0,0.000000,2194419,315761,514770889.000000
2023-07-20,Cboe C2 Options Exchange (W),2016674,250979,393160692.000000,8276,2693,12152718.000000,2024950,253672,405313410.000000
2023-07-20,Nasdaq PHLX (X),4652819,339281,1591060609.000000,38842,13518,367155433.000000,4691661,352799,1958216042.000000
2023-07-20,Cboe BZX Options Exchange (Z),2399866,343680,568692990.000000,4003,732,13434329.000000,2403869,344412,582127319.000000
2023-07-19,NYSE American Options (A),2922217,262292,919544207.000000,0,0,0.000000,2922217,262292,919544207.000000
2023-07-19,BOX Options (B),3011416,355442,1370730137.000000,0,0,0.000000,3011416,355442,1370730137.000000
2023-07-19,Cboe Options Exchange (C),4750601,662734,1726395058.000000,4651878,575676,9588245131.000000,9402479,1238410,11314640189.000000
2023-07-19,MIAX Emerald (D),1253850,220586,381581807.000000,0,0,0.000000,1253850,220586,381581807.000000
2023-07-19,Cboe EDGX Options Exchange (E),2385760,371154,557917976.000000,0,0,0.000000,2385760,371154,557917976.000000
2023-07-19,Nasdaq GEMX (H),1346775,193972,339579966.000000,907,345,35905612.000000,1347682,194317,375485578.000000
2023-07-19,Nasdaq ISE (I),2751808,337660,1411058421.000000,23634,8388,260367521.000000,2775442,346048,1671425942.000000
2023-07-19,Nasdaq MRX (J),870605,124847,233495208.000000,0,0,0.000000,870605,124847,233495208.000000
2023-07-19,MIAX Options Exchange (M),2707913,468178,860118391.000000,0,0,0.000000,2707913,468178,860118391.000000
2023-07-19,NYSE Arca Options (N),5266468,715651,1582892496.000000,0,0,0.000000,5266468,715651,1582892496.000000
2023-07-19,MIAX Pearl (P),2700477,326862,616719152.000000,0,0,0.000000,2700477,326862,616719152.000000
2023-07-19,NASDAQ Options Market (Q),2372085,381194,730476363.000000,0,0,0.000000,2372085,381194,730476363.000000
2023-07-19,Nasdaq BX Options (T),1879562,309220,565940938.000000,0,0,0.000000,1879562,309220,565940938.000000
2023-07-19,Cboe C2 Options Exchange (W),1900924,238004,407811714.000000,11103,3470,32782948.000000,1912027,241474,440594662.000000
2023-07-19,Nasdaq PHLX (X),5389193,331827,2543372083.000000,23800,9739,249205651.000000,5412993,341566,2792577734.000000
2023-07-19,Cboe BZX Options Exchange (Z),2154042,313847,597058421.000000,1959,325,7551626.000000,2156001,314172,604610047.000000
2023-07-18,NYSE American Options (A),2754534,251008,1041726878.000000,0,0,0.000000,2754534,251008,1041726878.000000
2023-07-18,BOX Options (B),2806636,343239,991021721.000000,0,0,0.000000,2806636,343239,991021721.000000
2023-07-18,Cboe Options Exchange (C),4582291,630889,1325168811.000000,4226473,571056,8002371464.000000,8808764,1201945,9327540275.000000
2023-07-18,MIAX Emerald (D),1129398,204736,345233700.000000,0,0,0.000000,1129398,204736,345233700.000000
2023-07-18,Cboe EDGX Options Exchange (E),2487010,366597,543162237.000000,0,0,0.000000,2487010,366597,543162237.000000
2023-07-18,Nasdaq GEMX (H),1296449,189541,349681157.000000,840,275,8454511.000000,1297289,189816,358135668.000000
2023-07-18,Nasdaq ISE (I),2603847,329412,1123653276.000000,30641,10059,283125967.000000,2634488,339471,1406779243.000000
2023-07-18,Nasdaq MRX (J),814078,121131,213516107.000000,0,0,0.000000,814078,121131,213516107.000000
2023-07-18,MIAX Options Exchange (M),2757597,420997,735817880.000000,0,0,0.000000,2757597,420997,735817880.000000
2023-07-18,NYSE Arca Options (N),4837456,694847,1536144521.000000,0,0,0.000000,4837456,694847,1536144521.000000
2023-07-18,MIAX Pearl (P),2503743,290961,605880442.000000,0,0,0.000000,2503743,290961,605880442.000000
2023-07-18,NASDAQ Options Market (Q),2323133,362996,748073662.000000,0,0,0.000000,2323133,362996,748073662.000000
2023-07-18,Nasdaq BX Options (T),1736216,267444,511174562.000000,0,0,0.000000,1736216,267444,511174562.000000
2023-07-18,Cboe C2 Options Exchange (W),1839937,226619,389745364.000000,9261,3102,19213301.000000,1849198,229721,408958665.000000
2023-07-18,Nasdaq PHLX (X),4495380,314813,1632206828.000000,30133,11104,259669902.000000,4525513,325917,1891876730.000000
2023-07-18,Cboe BZX Options Exchange (Z),1992359,294890,604071683.000000,1191,278,2572131.000000,1993550,295168,606643814.000000
2023-07-17,NYSE American Options (A),2432297,226532,767756669.000000,0,0,0.000000,2432297,226532,767756669.000000
2023-07-17,BOX Options (B),2392789,305127,691989219.000000,0,0,0.000000,2392789,305127,691989219.000000
2023-07-17,Cboe Options Exchange (C),4056850,600423,1131088003.000000,3288340,476219,5793338454.000000,7345190,1076642,6924426457.000000
2023-07-17,MIAX Emerald (D),1107151,193950,331465960.000000,0,0,0.000000,1107151,193950,331465960.000000
2023-07-17,Cboe EDGX Options Exchange (E),2115905,329203,473307557.000000,0,0,0.000000,2115905,329203,473307557.000000
2023-07-17,Nasdaq GEMX (H),1200305,178126,279055630.000000,857,243,15616979.000000,1201162,178369,294672609.000000
2023-07-17,Nasdaq ISE (I),2069323,278856,945800891.000000,22673,7539,197329387.000000,2091996,286395,1143130278.000000
2023-07-17,Nasdaq MRX (J),728992,108460,215366335.000000,0,0,0.000000,728992,108460,215366335.000000
2023-07-17,MIAX Options Exchange (M),2228463,383593,589079783.000000,0,0,0.000000,2228463,383593,589079783.000000
2023-07-17,NYSE Arca Options (N),4216101,598328,1663506726.000000,0,0,0.000000,4216101,598328,1663506726.000000
2023-07-17,MIAX Pearl (P),2290648,259842,498382305.000000,0,0,0.000000,2290648,259842,498382305.000000
2023-07-17,NASDAQ Options Market (Q),2076536,325596,653792661.000000,0,0,0.000000,2076536,325596,653792661.000000
2023-07-17,Nasdaq BX Options (T),1454066,234331,404621942.000000,0,0,0.000000,1454066,234331,404621942.000000
2023-07-17,Cboe C2 Options Exchange (W),1609927,211081,338364889.000000,10794,3309,10197875.000000,1620721,214390,348562764.000000
2023-07-17,Nasdaq PHLX (X),4178676,296447,1392306209.000000,23667,9383,235141283.000000,4202343,305830,1627447492.000000
2023-07-17,Cboe BZX Options Exchange (Z),1796643,270619,471114154.000000,1194,307,1991363.000000,1797837,270926,473105517.000000
2023-07-14,NYSE American Options (A),2843177,273380,800720083.000000,0,0,0.000000,2843177,273380,800720083.000000
2023-07-14,BOX Options (B),2960279,360502,889990889.000000,0,0,0.000000,2960279,360502,889990889.000000
2023-07-14,Cboe Options Exchange (C),5429390,728446,1419724075.000000,3575147,564796,6080040067.000000,9004537,1293242,7499764142.000000
2023-07-14,MIAX Emerald (D),1447773,240251,395808686.000000,0,0,0.000000,1447773,240251,395808686.000000
2023-07-14,Cboe EDGX Options Exchange (E),2918096,428656,554855780.000000,0,0,0.000000,2918096,428656,554855780.000000
2023-07-14,Nasdaq GEMX (H),1676365,236252,345307222.000000,1004,279,8350965.000000,1677369,236531,353658187.000000
2023-07-14,Nasdaq ISE (I),3092027,377682,1179617754.000000,23123,9293,264975807.000000,3115150,386975,1444593561.000000
2023-07-14,Nasdaq MRX (J),1047793,138091,247118971.000000,0,0,0.000000,1047793,138091,247118971.000000
2023-07-14,MIAX Options Exchange (M),3141793,492689,814559095.000000,0,0,0.000000,3141793,492689,814559095.000000
2023-07-14,NYSE Arca Options (N),5810940,772516,1745303146.000000,0,0,0.000000,5810940,772516,1745303146.000000
2023-07-14,MIAX Pearl (P),3268763,349859,610431709.000000,0,0,0.000000,3268763,349859,610431709.000000
2023-07-14,NASDAQ Options Market (Q),2953032,453396,791473236.000000,0,0,0.000000,2953032,453396,791473236.000000
2023-07-14,Nasdaq BX Options (T),1901653,301377,532024516.000000,0,0,0.000000,1901653,301377,532024516.000000
2023-07-14,Cboe C2 Options Exchange (W),2269729,279341,389688612.000000,10929,3437,9972325.000000,2280658,282778,399660937.000000
2023-07-14,Nasdaq PHLX (X),4849625,355044,1447530489.000000,21830,9491,179636490.000000,4871455,364535,1627166979.000000
2023-07-14,Cboe BZX Options Exchange (Z),2651608,357354,619575014.000000,2761,719,5427406.000000,2654369,358073,625002420.000000
2023-07-13,NYSE American Options (A),2870277,251257,910763423.000000,0,0,0.000000,2870277,251257,910763423.000000
2023-07-13,BOX Options (B),2894742,348126,742415656.000000,0,0,0.000000,2894742,348126,742415656.000000
2023-07-13,Cboe Options Exchange (C),5011032,708782,1444383393.000000,3603292,523694,7093605603.000000,8614324,1232476,8537988996.000000
2023-07-13,MIAX Emerald (D),1370466,227196,341779202.000000,0,0,0.000000,1370466,227196,341779202.000000
2023-07-13,Cboe EDGX Options Exchange (E),2507029,391889,521301624.000000,0,0,0.000000,2507029,391889,521301624.000000
2023-07-13,Nasdaq GEMX (H),1522243,220840,289380287.000000,1170,412,13271102.000000,1523413,221252,302651389.000000
2023-07-13,Nasdaq ISE (I),2779245,339485,1118740260.000000,21296,8481,164859213.000000,2800541,347966,1283599473.000000
2023-07-13,Nasdaq MRX (J),961810,123895,225461803.000000,0,0,0.000000,961810,123895,225461803.000000
2023-07-13,MIAX Options Exchange (M),2985850,461399,681074516.000000,0,0,0.000000,2985850,461399,681074516.000000
2023-07-13,NYSE Arca Options (N),5376680,733523,1683812871.000000,2,1,3320.000000,5376682,733524,1683816191.000000
2023-07-13,MIAX Pearl (P),2966294,324031,558299586.000000,0,0,0.000000,2966294,324031,558299586.000000
2023-07-13,NASDAQ Options Market (Q),2636396,401999,679082805.000000,0,0,0.000000,2636396,401999,679082805.000000
2023-07-13,Nasdaq BX Options (T),1521670,234629,351362871.000000,0,0,0.000000,1521670,234629,351362871.000000
2023-07-13,Cboe C2 Options Exchange (W),2007086,253245,361494016.000000,10111,3096,21313309.000000,2017197,256341,382807325.000000
2023-07-13,Nasdaq PHLX (X),5257748,343272,1614421498.000000,23124,9146,216227710.000000,5280872,352418,1830649208.000000
2023-07-13,Cboe BZX Options Exchange (Z),2306487,328650,563919719.000000,1346,277,2677903.000000,2307833,328927,566597622.000000
2023-07-12,NYSE American Options (A),2794356,248740,822112835.000000,1,1,300.000000,2794357,248741,822113135.000000
2023-07-12,BOX Options (B),2886861,329254,1041712356.000000,0,0,0.000000,2886861,329254,1041712356.000000
2023-07-12,Cboe Options Exchange (C),4949017,660426,1509921735.000000,4177747,602966,6541790349.000000,9126764,1263392,8051712084.000000
2023-07-12,MIAX Emerald (D),1305505,229137,317911580.000000,0,0,0.000000,1305505,229137,317911580.000000
2023-07-12,Cboe EDGX Options Exchange (E),2430057,364976,464340209.000000,0,0,0.000000,2430057,364976,464340209.000000
2023-07-12,Nasdaq GEMX (H),1383316,197814,266698579.000000,790,289,8750670.000000,1384106,198103,275449249.000000
2023-07-12,Nasdaq ISE (I),2539178,315853,1027402026.000000,21976,9459,273762509.000000,2561154,325312,1301164535.000000
2023-07-12,Nasdaq MRX (J),824720,115352,174255299.000000,0,0,0.000000,824720,115352,174255299.000000
2023-07-12,MIAX Options Exchange (M),2800419,423372,599633653.000000,0,0,0.000000,2800419,423372,599633653.000000
2023-07-12,NYSE Arca Options (N),5225988,686947,1390365992.000000,2,1,3380.000000,5225990,686948,1390369372.000000
2023-07-12,MIAX Pearl (P),2796297,312721,520800247.000000,0,0,0.000000,2796297,312721,520800247.000000
2023-07-12,NASDAQ Options Market (Q),2464111,376672,621100145.000000,0,0,0.000000,2464111,376672,621100145.000000
2023-07-12,Nasdaq BX Options (T),1546555,264478,425264236.000000,0,0,0.000000,1546555,264478,425264236.000000
2023-07-12,Cboe C2 Options Exchange (W),1820507,234018,326947689.000000,11891,4123,22699943.000000,1832398,238141,349647632.000000
2023-07-12,Nasdaq PHLX (X),5518006,324200,2479661920.000000,18788,8660,177613777.000000,5536794,332860,2657275697.000000
2023-07-12,Cboe BZX Options Exchange (Z),2258180,323355,517093382.000000,2903,436,5083065.000000,2261083,323791,522176447.000000
2023-07-11,NYSE American Options (A),2300139,208739,669659481.000000,0,0,0.000000,2300139,208739,669659481.000000
2023-07-11,BOX Options (B),2190948,277501,516962438.000000,0,0,0.000000,2190948,277501,516962438.000000
2023-07-11,Cboe Options Exchange (C),4266849,551388,1104834178.000000,3310884,520075,4282578911.000000,7577733,1071463,5387413089.000000
2023-07-11,MIAX Emerald (D),1083290,190996,221161952.000000,0,0,0.000000,1083290,190996,221161952.000000
2023-07-11,Cboe EDGX Options Exchange (E),2078429,317430,325433236.000000,0,0,0.000000,2078429,317430,325433236.000000
2023-07-11,Nasdaq GEMX (H),1174126,173546,208732640.000000,775,422,9587175.000000,1174901,173968,218319815.000000
2023-07-11,Nasdaq ISE (I),2002618,252984,771034119.000000,13913,6648,80212126.000000,2016531,259632,851246245.000000
2023-07-11,Nasdaq MRX (J),638692,95313,124422517.000000,0,0,0.000000,638692,95313,124422517.000000
2023-07-11,MIAX Options Exchange (M),2528170,359653,464324661.000000,0,0,0.000000,2528170,359653,464324661.000000
2023-07-11,NYSE Arca Options (N),4117992,588567,1038503024.000000,0,0,0.000000,4117992,588567,1038503024.000000
2023-07-11,MIAX Pearl (P),2365419,271448,421363816.000000,0,0,0.000000,2365419,271448,421363816.000000
2023-07-11,NASDAQ Options Market (Q),2143397,332400,520349715.000000,0,0,0.000000,2143397,332400,520349715.000000
2023-07-11,Nasdaq BX Options (T),1258708,220111,337911483.000000,0,0,0.000000,1258708,220111,337911483.000000
2023-07-11,Cboe C2 Options Exchange (W),1579973,196386,244043202.000000,8188,2681,12845527.000000,1588161,199067,256888729.000000
2023-07-11,Nasdaq PHLX (X),4088145,275799,1192634570.000000,14468,6653,80272487.000000,4102613,282452,1272907057.000000
2023-07-11,Cboe BZX Options Exchange (Z),2074747,296447,414466351.000000,1420,450,4900652.000000,2076167,296897,419367003.000000
2023-07-10,NYSE American Options (A),2429731,211817,795311786.000000,0,0,0.000000,2429731,211817,795311786.000000
2023-07-10,BOX Options (B),2093166,264966,640348386.000000,0,0,0.000000,2093166,264966,640348386.000000
2023-07-10,Cboe Options Exchange (C),3818837,536216,908611904.000000,2608058,516798,3722133216.000000,6426895,1053014,4630745120.000000
2023-07-10,MIAX Emerald (D),959077,184300,245746953.000000,0,0,0.000000,959077,184300,245746953.000000
2023-07-10,Cboe EDGX Options Exchange (E),1975386,313119,332020588.000000,0,0,0.000000,1975386,313119,332020588.000000
2023-07-10,Nasdaq GEMX (H),1064680,162587,208927564.000000,544,279,14298659.000000,1065224,162866,223226223.000000
2023-07-10,Nasdaq ISE (I),1835748,242751,579405375.000000,16465,7274,59977336.000000,1852213,250025,639382711.000000
2023-07-10,Nasdaq MRX (J),641022,97501,126993041.000000,0,0,0.000000,641022,97501,126993041.000000
2023-07-10,MIAX Options Exchange (M),2061729,345146,444939891.000000,0,0,0.000000,2061729,345146,444939891.000000
2023-07-10,NYSE Arca Options (N),3791400,554927,939281237.000000,2,2,1780.000000,3791402,554929,939283017.000000
2023-07-10,MIAX Pearl (P),2117504,248441,410785515.000000,0,0,0.000000,2117504,248441,410785515.000000
2023-07-10,NASDAQ Options Market (Q),1949220,307627,503846949.000000,0,0,0.000000,1949220,307627,503846949.000000
2023-07-10,Nasdaq BX Options (T),1282170,231402,422088723.000000,0,0,0.000000,1282170,231402,422088723.000000
2023-07-10,Cboe C2 Options Exchange (W),1386135,183405,231241341.000000,9549,2930,17567897.000000,1395684,186335,248809238.000000
2023-07-10,Nasdaq PHLX (X),3540129,273316,1124648676.000000,14325,7246,71587182.000000,3554454,280562,1196235858.000000
2023-07-10,Cboe BZX Options Exchange (Z),1861354,276680,455002720.000000,2516,528,6912330.000000,1863870,277208,461915050.000000
2023-07-07,NYSE American Options (A),2380421,237418,496878458.000000,0,0,0.000000,2380421,237418,496878458.000000
2023-07-07,BOX Options (B),2388826,279139,573057497.000000,0,0,0.000000,2388826,279139,573057497.000000
2023-07-07,Cboe Options Exchange (C),4516564,621039,1011358866.000000,3632576,600565,5715380064.000000,8149140,1221604,6726738930.000000
2023-07-07,MIAX Emerald (D),1182820,201933,243557794.000000,0,0,0.000000,1182820,201933,243557794.000000
2023-07-07,Cboe EDGX Options Exchange (E),2288705,345179,369270985.000000,0,0,0.000000,2288705,345179,369270985.000000
2023-07-07,Nasdaq GEMX (H),1268842,175366,211863076.000000,517,260,9762397.000000,1269359,175626,221625473.000000
2023-07-07,Nasdaq ISE (I),2480432,311512,760698732.000000,22244,8952,107511691.000000,2502676,320464,868210423.000000
2023-07-07,Nasdaq MRX (J),784304,116595,142799091.000000,0,0,0.000000,784304,116595,142799091.000000
2023-07-07,MIAX Options Exchange (M),2717385,414182,514896436.000000,0,0,0.000000,2717385,414182,514896436.000000
2023-07-07,NYSE Arca Options (N),4511112,615915,1045590508.000000,0,0,0.000000,4511112,615915,1045590508.000000
2023-07-07,MIAX Pearl (P),2689292,280395,431185910.000000,0,0,0.000000,2689292,280395,431185910.000000
2023-07-07,NASDAQ Options Market (Q),2484730,367644,516791318.000000,0,0,0.000000,2484730,367644,516791318.000000
2023-07-07,Nasdaq BX Options (T),1393863,222784,342010445.000000,0,0,0.000000,1393863,222784,342010445.000000
2023-07-07,Cboe C2 Options Exchange (W),1781057,223717,273154044.000000,10723,3700,13032922.000000,1791780,227417,286186966.000000
2023-07-07,Nasdaq PHLX (X),4242037,290721,1138233781.000000,21701,9899,124635344.000000,4263738,300620,1262869125.000000
2023-07-07,Cboe BZX Options Exchange (Z),2378502,316944,482947047.000000,2014,437,5275089.000000,2380516,317381,488222136.000000
2023-07-06,NYSE American Options (A),2399677,207250,497705660.000000,0,0,0.000000,2399677,207250,497705660.000000
2023-07-06,BOX Options (B),2911680,259097,875623383.000000,0,0,0.000000,2911680,259097,875623383.000000
2023-07-06,Cboe Options Exchange (C),4156514,552570,1039424173.000000,4193867,568583,6849779284.000000,8350381,1121153,7889203457.000000
2023-07-06,MIAX Emerald (D),1062936,181044,247653316.000000,0,0,0.000000,1062936,181044,247653316.000000
2023-07-06,Cboe EDGX Options Exchange (E),2118620,313422,375442752.000000,0,0,0.000000,2118620,313422,375442752.000000
2023-07-06,Nasdaq GEMX (H),1161109,157553,211998330.000000,640,201,7023345.000000,1161749,157754,219021675.000000
2023-07-06,Nasdaq ISE (I),2180543,263378,629072275.000000,20190,7608,103139977.000000,2200733,270986,732212252.000000
2023-07-06,Nasdaq MRX (J),727193,100908,141091808.000000,0,0,0.000000,727193,100908,141091808.000000
2023-07-06,MIAX Options Exchange (M),2379201,358044,480424613.000000,90,4,33750.000000,2379291,358048,480458363.000000
2023-07-06,NYSE Arca Options (N),4342455,570942,1175861000.000000,0,0,0.000000,4342455,570942,1175861000.000000
2023-07-06,MIAX Pearl (P),2546882,263937,476763127.000000,0,0,0.000000,2546882,263937,476763127.000000
2023-07-06,NASDAQ Options Market (Q),2399260,345970,643695035.000000,0,0,0.000000,2399260,345970,643695035.000000
2023-07-06,Nasdaq BX Options (T),1360762,210340,359926865.000000,0,0,0.000000,1360762,210340,359926865.000000
2023-07-06,Cboe C2 Options Exchange (W),1642695,201766,296100788.000000,11053,4016,19310485.000000,1653748,205782,315411273.000000
2023-07-06,Nasdaq PHLX (X),4662645,260628,1514019029.000000,16602,6923,103922914.000000,4679247,267551,1617941943.000000
2023-07-06,Cboe BZX Options Exchange (Z),2098363,282726,484280037.000000,833,300,1504781.000000,2099196,283026,485784818.000000
2023-07-05,NYSE American Options (A),2244324,218831,583817243.000000,0,0,0.000000,2244324,218831,583817243.000000
2023-07-05,BOX Options (B),2464591,256872,1232954359.000000,0,0,0.000000,2464591,256872,1232954359.000000
2023-07-05,Cboe Options Exchange (C),3731478,532777,1202878138.000000,2869498,446533,4102650175.000000,6600976,979310,5305528313.000000
2023-07-05,MIAX Emerald (D),919219,160284,234088536.000000,0,0,0.000000,919219,160284,234088536.000000
2023-07-05,Cboe EDGX Options Exchange (E),1753265,278371,338063644.000000,0,0,0.000000,1753265,278371,338063644.000000
2023-07-05,Nasdaq GEMX (H),931431,138146,178712940.000000,470,226,5966955.000000,931901,138372,184679895.000000
2023-07-05,Nasdaq ISE (I),1834447,225416,569007657.000000,17527,7345,111914851.500000,1851974,232761,680922508.500000
2023-07-05,Nasdaq MRX (J),626844,92245,127079222.000000,0,0,0.000000,626844,92245,127079222.000000
2023-07-05,MIAX Options Exchange (M),2081867,348858,483118858.000000,0,0,0.000000,2081867,348858,483118858.000000
2023-07-05,NYSE Arca Options (N),3870203,526008,978261592.000000,0,0,0.000000,3870203,526008,978261592.000000
2023-07-05,MIAX Pearl (P),1953676,216609,357399357.000000,0,0,0.000000,1953676,216609,357399357.000000
2023-07-05,NASDAQ Options Market (Q),1766130,270242,464779364.000000,0,0,0.000000,1766130,270242,464779364.000000
2023-07-05,Nasdaq BX Options (T),1006608,168440,274924684.000000,0,0,0.000000,1006608,168440,274924684.000000
2023-07-05,Cboe C2 Options Exchange (W),1325773,172890,232504215.000000,8259,2821,7988540.000000,1334032,175711,240492755.000000
2023-07-05,Nasdaq PHLX (X),2826158,139998,2130071984.000000,10130,5212,64182767.000000,2836288,145210,2194254751.000000
2023-07-05,Cboe BZX Options Exchange (Z),1620358,238553,419003907.000000,894,171,1374065.000000,1621252,238724,420377972.000000
2023-07-03,NYSE American Options (A),1413341,142550,314529631.000000,0,0,0.000000,1413341,142550,314529631.000000
2023-07-03,BOX Options (B),1246346,171972,476930080.000000,0,0,0.000000,1246346,171972,476930080.000000
2023-07-03,Cboe Options Exchange (C),2497309,382354,716959743.000000,1457302,235389,2512312413.000000,3954611,617743,3229272156.000000
2023-07-03,MIAX Emerald (D),790861,138126,213389013.000000,0,0,0.000000,790861,138126,213389013.000000
2023-07-03,Cboe EDGX Options Exchange (E),1229707,203827,252996568.000000,0,0,0.000000,1229707,203827,252996568.000000
2023-07-03,Nasdaq GEMX (H),724874,114116,156202094.000000,448,77,3349325.000000,725322,114193,159551419.000000
2023-07-03,Nasdaq ISE (I),1226284,173972,498458949.000000,11264,4293,59281553.000000,1237548,178265,557740502.000000
2023-07-03,Nasdaq MRX (J),462828,72883,119020852.000000,0,0,0.000000,462828,72883,119020852.000000
2023-07-03,MIAX Options Exchange (M),1388329,251669,384971513.000000,0,0,0.000000,1388329,251669,384971513.000000
2023-07-03,NYSE Arca Options (N),2300214,356427,627623299.000000,1,1,930.000000,2300215,356428,627624229.000000
2023-07-03,MIAX Pearl (P),1406371,163614,283367893.000000,0,0,0.000000,1406371,163614,283367893.000000
2023-07-03,NASDAQ Options Market (Q),1258272,218620,322550772.000000,0,0,0.000000,1258272,218620,322550772.000000
2023-07-03,Nasdaq BX Options (T),604029,111604,136218812.000000,0,0,0.000000,604029,111604,136218812.000000
2023-07-03,Cboe C2 Options Exchange (W),950081,128114,172595658.000000,6451,1813,8689933.000000,956532,129927,181285591.000000
2023-07-03,Nasdaq PHLX (X),2334602,184869,911329277.000000,9282,4202,45780058.000000,2343884,189071,957109335.000000
2023-07-03,Cboe BZX Options Exchange (Z),1247837,193413,328932934.000000,443,56,723300.000000,1248280,193469,329656234.000000
2023-06-30,NYSE American Options (A),3101619,256110,683128526.000000,0,0,0.000000,3101619,256110,683128526.000000
2023-06-30,BOX Options (B),2646221,289978,764550131.000000,0,0,0.000000,2646221,289978,764550131.000000
2023-06-30,Cboe Options Exchange (C),4951452,683714,1159429971.000000,4638916,594453,9499723776.000000,9590368,1278167,10659153747.000000
2023-06-30,MIAX Emerald (D),1309145,212958,306801437.000000,0,0,0.000000,1309145,212958,306801437.000000
2023-06-30,Cboe EDGX Options Exchange (E),2475455,366825,441258686.000000,0,0,0.000000,2475455,366825,441258686.000000
2023-06-30,Nasdaq GEMX (H),1340787,176650,242462456.000000,1097,325,14230587.000000,1341884,176975,256693043.000000
2023-06-30,Nasdaq ISE (I),2764487,323326,992672740.000000,17033,6954,136646180.000000,2781520,330280,1129318920.000000
2023-06-30,Nasdaq MRX (J),862444,119772,182088270.000000,0,0,0.000000,862444,119772,182088270.000000
2023-06-30,MIAX Options Exchange (M),3131800,435975,645823006.000000,0,0,0.000000,3131800,435975,645823006.000000
2023-06-30,NYSE Arca Options (N),5223160,670789,1280321787.000000,0,0,0.000000,5223160,670789,1280321787.000000
2023-06-30,MIAX Pearl (P),2794462,286233,493164711.000000,0,0,0.000000,2794462,286233,493164711.000000
2023-06-30,NASDAQ Options Market (Q),2543993,374174,597401434.000000,0,0,0.000000,2543993,374174,597401434.000000
2023-06-30,Nasdaq BX Options (T),1227299,192824,242415052.000000,0,0,0.000000,1227299,192824,242415052.000000
2023-06-30,Cboe C2 Options Exchange (W),1943626,237581,334288372.000000,14383,4559,16434044.000000,1958009,242140,350722416.000000
2023-06-30,Nasdaq PHLX (X),4321641,285431,1212305421.000000,19758,8523,161920128.000000,4341399,293954,1374225549.000000
2023-06-30,Cboe BZX Options Exchange (Z),2362558,304986,513371519.000000,558,132,925619.000000,2363116,305118,514297138.000000
2023-06-29,NYSE American Options (A),2166066,208234,496008021.000000,0,0,0.000000,2166066,208234,496008021.000000
2023-06-29,BOX Options (B),2247160,241640,917959220.000000,0,0,0.000000,2247160,241640,917959220.000000
2023-06-29,Cboe Options Exchange (C),3806588,527930,967253464.000000,2835123,537453,4089917779.000000,6641711,1065383,5057171243.000000
2023-06-29,MIAX Emerald (D),1027495,170216,192933521.000000,0,0,0.000000,1027495,170216,192933521.000000
2023-06-29,Cboe EDGX Options Exchange (E),1957912,292565,293976914.000000,0,0,0.000000,1957912,292565,293976914.000000
2023-06-29,Nasdaq GEMX (H),1034314,139390,163502931.000000,641,179,6383908.000000,1034955,139569,169886839.000000
2023-06-29,Nasdaq ISE (I),1879641,234998,527022201.000000,14115,6217,94053858.000000,1893756,241215,621076059.000000
2023-06-29,Nasdaq MRX (J),650248,93486,104964123.000000,0,0,0.000000,650248,93486,104964123.000000
2023-06-29,MIAX Options Exchange (M),2132978,330512,401281307.000000,0,0,0.000000,2132978,330512,401281307.000000
2023-06-29,NYSE Arca Options (N),4176325,562871,946194038.000000,2,1,1700.000000,4176327,562872,946195738.000000
2023-06-29,MIAX Pearl (P),2335845,256999,377694575.000000,0,0,0.000000,2335845,256999,377694575.000000
2023-06-29,NASDAQ Options Market (Q),2135419,313796,435266001.000000,0,0,0.000000,2135419,313796,435266001.000000
2023-06-29,Nasdaq BX Options (T),1036027,161894,162416238.000000,0,0,0.000000,1036027,161894,162416238.000000
2023-06-29,Cboe C2 Options Exchange (W),1500429,182115,207933443.000000,10341,3400,12699376.000000,1510770,185515,220632819.000000
2023-06-29,Nasdaq PHLX (X),3780672,242572,1756879177.000000,15526,6615,104350334.000000,3796198,249187,1861229511.000000
2023-06-29,Cboe BZX Options Exchange (Z),1893860,259519,383452890.000000,945,267,1975225.000000,1894805,259786,385428115.000000
2023-06-28,NYSE American Options (A),2051916,215323,399121916.000000,0,0,0.000000,2051916,215323,399121916.000000
2023-06-28,BOX Options (B),2471487,266241,1192569631.000000,0,0,0.000000,2471487,266241,1192569631.000000
2023-06-28,Cboe Options Exchange (C),3816330,536131,1335524698.000000,3305686,573205,6452807720.000000,7122016,1109336,7788332418.000000
2023-06-28,MIAX Emerald (D),1063584,179495,243054875.000000,0,0,0.000000,1063584,179495,243054875.000000
2023-06-28,Cboe EDGX Options Exchange (E),2085749,307875,349088539.000000,0,0,0.000000,2085749,307875,349088539.000000
2023-06-28,Nasdaq GEMX (H),1067195,147482,195181829.000000,782,290,9916817.000000,1067977,147772,205098646.000000
2023-06-28,Nasdaq ISE (I),1808775,243441,624022609.500000,19377,7892,186888125.000000,1828152,251333,810910734.500000
2023-06-28,Nasdaq MRX (J),695796,104967,139438957.000000,0,0,0.000000,695796,104967,139438957.000000
2023-06-28,MIAX Options Exchange (M),2259831,355165,474359130.000000,0,0,0.000000,2259831,355165,474359130.000000
2023-06-28,NYSE Arca Options (N),4529981,602442,1364675883.000000,0,0,0.000000,4529981,602442,1364675883.000000
2023-06-28,MIAX Pearl (P),2492929,270629,438142388.000000,0,0,0.000000,2492929,270629,438142388.000000
2023-06-28,NASDAQ Options Market (Q),2266933,343720,764554526.000000,0,0,0.000000,2266933,343720,764554526.000000
2023-06-28,Nasdaq BX Options (T),1099632,181260,215363519.000000,0,0,0.000000,1099632,181260,215363519.000000
2023-06-28,Cboe C2 Options Exchange (W),1546691,181920,321517689.000000,9576,2677,11341512.000000,1556267,184597,332859201.000000
2023-06-28,Nasdaq PHLX (X),4227094,258142,2358434124.000000,24180,8528,137795332.000000,4251274,266670,2496229456.000000
2023-06-28,Cboe BZX Options Exchange (Z),2060478,282910,483687949.000000,482,108,1285075.000000,2060960,283018,484973024.000000
2023-06-27,NYSE American Options (A),2292427,211297,542855028.000000,0,0,0.000000,2292427,211297,542855028.000000
2023-06-27,BOX Options (B),1894129,260713,557877502.000000,0,0,0.000000,1894129,260713,557877502.000000
2023-06-27,Cboe Options Exchange (C),3875094,518704,944486963.000000,3297957,590240,7487085921.000000,7173051,1108944,8431572884.000000
2023-06-27,MIAX Emerald (D),996523,180432,231862448.000000,0,0,0.000000,996523,180432,231862448.000000
2023-06-27,Cboe EDGX Options Exchange (E),1972280,301852,379038174.000000,0,0,0.000000,1972280,301852,379038174.000000
2023-06-27,Nasdaq GEMX (H),951797,135570,197080261.000000,499,242,7567425.000000,952296,135812,204647686.000000
2023-06-27,Nasdaq ISE (I),1908665,240870,651091998.500000,20297,7857,114741435.000000,1928962,248727,765833433.500000
2023-06-27,Nasdaq MRX (J),668324,102016,156754239.000000,0,0,0.000000,668324,102016,156754239.000000
2023-06-27,MIAX Options Exchange (M),2048156,340145,469687920.000000,0,0,0.000000,2048156,340145,469687920.000000
2023-06-27,NYSE Arca Options (N),4299738,558440,1103794052.000000,0,0,0.000000,4299738,558440,1103794052.000000
2023-06-27,MIAX Pearl (P),2324616,249286,419845589.000000,0,0,0.000000,2324616,249286,419845589.000000
2023-06-27,NASDAQ Options Market (Q),2153726,317520,540950833.000000,0,0,0.000000,2153726,317520,540950833.000000
2023-06-27,Nasdaq BX Options (T),962533,153665,155734964.000000,0,0,0.000000,962533,153665,155734964.000000
2023-06-27,Cboe C2 Options Exchange (W),1462290,181143,273165949.000000,8385,2906,11893287.000000,1470675,184049,285059236.000000
2023-06-27,Nasdaq PHLX (X),3799441,248468,1102479608.000000,19654,8293,113983733.000000,3819095,256761,1216463341.000000
2023-06-27,Cboe BZX Options Exchange (Z),1986782,270128,442912737.000000,1194,226,3129440.000000,1987976,270354,446042177.000000
2023-06-26,NYSE American Options (A),2044864,215532,486724616.000000,0,0,0.000000,2044864,215532,486724616.000000
2023-06-26,BOX Options (B),1974318,250738,708610318.000000,0,0,0.000000,1974318,250738,708610318.000000
2023-06-26,Cboe Options Exchange (C),3676937,533540,949359984.000000,3131038,582824,5342270777.000000,6807975,1116364,6291630761.000000
2023-06-26,MIAX Emerald (D),1018300,184659,272888664.000000,0,0,0.000000,1018300,184659,272888664.000000
2023-06-26,Cboe EDGX Options Exchange (E),1991338,304161,364879731.000000,0,0,0.000000,1991338,304161,364879731.000000
2023-06-26,Nasdaq GEMX (H),907580,132655,179082512.000000,1098,163,9418020.000000,908678,132818,188500532.000000
2023-06-26,Nasdaq ISE (I),1792422,234299,583013581.000000,19376,8600,98204279.000000,1811798,242899,681217860.000000
2023-06-26,Nasdaq MRX (J),640928,97573,141263353.000000,0,0,0.000000,640928,97573,141263353.000000
2023-06-26,MIAX Options Exchange (M),2121410,359615,540889810.000000,5,1,840.000000,2121415,359616,540890650.000000
2023-06-26,NYSE Arca Options (N),4065750,579447,1023577771.000000,0,0,0.000000,4065750,579447,1023577771.000000
2023-06-26,MIAX Pearl (P),2383757,258538,445505666.000000,0,0,0.000000,2383757,258538,445505666.000000
2023-06-26,NASDAQ Options Market (Q),2165110,314776,534868917.000000,0,0,0.000000,2165110,314776,534868917.000000
2023-06-26,Nasdaq BX Options (T),965983,142925,162416291.000000,0,0,0.000000,965983,142925,162416291.000000
2023-06-26,Cboe C2 Options Exchange (W),1569454,196360,305121717.000000,14965,3552,22981867.000000,1584419,199912,328103584.000000
2023-06-26,Nasdaq PHLX (X),3208928,242883,1061761934.000000,20292,9781,97166299.000000,3229220,252664,1158928233.000000
2023-06-26,Cboe BZX Options Exchange (Z),1996107,272402,487470879.000000,724,250,2660020.000000,1996831,272652,490130899.000000
2023-06-23,NYSE American Options (A),2205357,234883,524129913.000000,0,0,0.000000,2205357,234883,524129913.000000
2023-06-23,BOX Options (B),2256783,277537,656144455.000000,0,0,0.000000,2256783,277537,656144455.000000
2023-06-23,Cboe Options Exchange (C),4269758,601380,1030161587.000000,3326926,582189,5319992494.000000,7596684,1183569,6350154081.000000
2023-06-23,MIAX Emerald (D),1177579,193599,258339356.000000,0,0,0.000000,1177579,193599,258339356.000000
2023-06-23,Cboe EDGX Options Exchange (E),2271849,337387,366836081.000000,0,0,0.000000,2271849,337387,366836081.000000
2023-06-23,Nasdaq GEMX (H),1217477,160244,193446829.000000,917,340,14757749.000000,1218394,160584,208204578.000000
2023-06-23,Nasdaq ISE (I),2332038,285987,795152753.000000,17765,7576,86458899.000000,2349803,293563,881611652.000000
2023-06-23,Nasdaq MRX (J),827377,107805,144961682.000000,0,0,0.000000,827377,107805,144961682.000000
2023-06-23,MIAX Options Exchange (M),2558100,406717,516235299.000000,0,0,0.000000,2558100,406717,516235299.000000
2023-06-23,NYSE Arca Options (N),4833741,620047,1108766216.000000,0,0,0.000000,4833741,620047,1108766216.000000
2023-06-23,MIAX Pearl (P),2683648,279762,448638987.000000,0,0,0.000000,2683648,279762,448638987.000000
2023-06-23,NASDAQ Options Market (Q),2493777,373315,546921977.000000,0,0,0.000000,2493777,373315,546921977.000000
2023-06-23,Nasdaq BX Options (T),1057076,159601,143585721.000000,0,0,0.000000,1057076,159601,143585721.000000
2023-06-23,Cboe C2 Options Exchange (W),1832973,220956,307132333.000000,25029,5462,33198920.000000,1858002,226418,340331253.000000
2023-06-23,Nasdaq PHLX (X),3928017,274225,1087955378.000000,16864,8724,132869111.000000,3944881,282949,1220824489.000000
2023-06-23,Cboe BZX Options Exchange (Z),2310678,299632,470995650.000000,2807,818,9090726.000000,2313485,300450,480086376.000000
2023-06-22,NYSE American Options (A),2065733,211771,942305993.000000,0,0,0.000000,2065733,211771,942305993.000000
2023-06-22,BOX Options (B),2187871,257696,687907929.000000,0,0,0.000000,2187871,257696,687907929.000000
2023-06-22,Cboe Options Exchange (C),3909582,554804,1023513106.000000,3402022,538340,5859849761.000000,7311604,1093144,6883362867.000000
2023-06-22,MIAX Emerald (D),1035212,180033,249316462.000000,0,0,0.000000,1035212,180033,249316462.000000
2023-06-22,Cboe EDGX Options Exchange (E),2025159,303136,368956267.000000,0,0,0.000000,2025159,303136,368956267.000000
2023-06-22,Nasdaq GEMX (H),1050356,150007,210040137.000000,466,97,7026870.000000,1050822,150104,217067007.000000
2023-06-22,Nasdaq ISE (I),2001813,244930,676181524.000000,15891,6637,103220305.000000,2017704,251567,779401829.000000
2023-06-22,Nasdaq MRX (J),709336,97665,141578196.000000,0,0,0.000000,709336,97665,141578196.000000
2023-06-22,MIAX Options Exchange (M),2573771,356420,532666304.000000,9,9,90720.000000,2573780,356429,532757024.000000
2023-06-22,NYSE Arca Options (N),4359420,577620,1117065743.000000,0,0,0.000000,4359420,577620,1117065743.000000
2023-06-22,MIAX Pearl (P),2426001,259459,458030833.000000,0,0,0.000000,2426001,259459,458030833.000000
2023-06-22,NASDAQ Options Market (Q),2259366,341292,558225227.000000,0,0,0.000000,2259366,341292,558225227.000000
2023-06-22,Nasdaq BX Options (T),1033639,151418,162443925.000000,0,0,0.000000,1033639,151418,162443925.000000
2023-06-22,Cboe C2 Options Exchange (W),1569964,191298,321462842.000000,10332,3068,17732582.000000,1580296,194366,339195424.000000
2023-06-22,Nasdaq PHLX (X),3981391,253558,1161103802.000000,15684,7408,87551440.000000,3997075,260966,1248655242.000000
2023-06-22,Cboe BZX Options Exchange (Z),1978020,269246,451311292.000000,1868,502,8257030.000000,1979888,269748,459568322.000000
2023-06-21,NYSE American Options (A),2448104,234977,573939476.000000,0,0,0.000000,2448104,234977,573939476.000000
2023-06-21,BOX Options (B),2609499,280249,1452427696.000000,0,0,0.000000,2609499,280249,1452427696.000000
2023-06-21,Cboe Options Exchange (C),3993990,573070,1182571225.000000,3768027,578803,6012747376.000000,7762017,1151873,7195318601.000000
2023-06-21,MIAX Emerald (D),1144231,198433,326340516.000000,0,0,0.000000,1144231,198433,326340516.000000
2023-06-21,Cboe EDGX Options Exchange (E),2093059,321944,488495113.000000,0,0,0.000000,2093059,321944,488495113.000000
2023-06-21,Nasdaq GEMX (H),1081214,158957,245068626.000000,563,227,9039160.000000,1081777,159184,254107786.000000
2023-06-21,Nasdaq ISE (I),2124400,269372,818344740.000000,17819,7311,218338946.000000,2142219,276683,1036683686.000000
2023-06-21,Nasdaq MRX (J),734322,106014,158724532.000000,0,0,0.000000,734322,106014,158724532.000000
2023-06-21,MIAX Options Exchange (M),2475075,394906,665463983.000000,5,3,1100.000000,2475080,394909,665465083.000000
2023-06-21,NYSE Arca Options (N),4593236,644985,1485625683.000000,0,0,0.000000,4593236,644985,1485625683.000000
2023-06-21,MIAX Pearl (P),2640638,291249,554839273.000000,0,0,0.000000,2640638,291249,554839273.000000
2023-06-21,NASDAQ Options Market (Q),2445093,379119,705557152.000000,0,0,0.000000,2445093,379119,705557152.000000
2023-06-21,Nasdaq BX Options (T),1100040,167682,180909447.000000,0,0,0.000000,1100040,167682,180909447.000000
2023-06-21,Cboe C2 Options Exchange (W),1611785,196142,353544510.000000,11285,3469,15017750.000000,1623070,199611,368562260.000000
2023-06-21,Nasdaq PHLX (X),4408508,268157,2688674753.000000,16893,7759,138330243.000000,4425401,275916,2827004996.000000
2023-06-21,Cboe BZX Options Exchange (Z),2081356,301330,511805286.000000,2731,857,10094291.000000,2084087,302187,521899577.000000
2023-06-20,NYSE American Options (A),2061951,239360,537007074.000000,0,0,0.000000,2061951,239360,537007074.000000
2023-06-20,BOX Options (B),2495981,294108,1561041146.000000,0,0,0.000000,2495981,294108,1561041146.000000
2023-06-20,Cboe Options Exchange (C),4200120,601965,1333756209.000000,4358726,582700,10186642082.000000,8558846,1184665,11520398291.000000
2023-06-20,MIAX Emerald (D),1181543,204939,318147982.000000,0,0,0.000000,1181543,204939,318147982.000000
2023-06-20,Cboe EDGX Options Exchange (E),2180080,345579,442281603.000000,0,0,0.000000,2180080,345579,442281603.000000
2023-06-20,Nasdaq GEMX (H),1087628,156703,235655446.000000,945,358,17590910.000000,1088573,157061,253246356.000000
2023-06-20,Nasdaq ISE (I),2210604,276822,971752429.000000,14734,6252,211431941.000000,2225338,283074,1183184370.000000
2023-06-20,Nasdaq MRX (J),706676,106313,163990964.000000,0,0,0.000000,706676,106313,163990964.000000
2023-06-20,MIAX Options Exchange (M),2443513,388666,663562206.000000,0,0,0.000000,2443513,388666,663562206.000000
2023-06-20,NYSE Arca Options (N),4623259,639294,1375532272.000000,0,0,0.000000,4623259,639294,1375532272.000000
2023-06-20,MIAX Pearl (P),2517065,275762,527560217.000000,0,0,0.000000,2517065,275762,527560217.000000
2023-06-20,NASDAQ Options Market (Q),2292144,370589,616335540.000000,0,0,0.000000,2292144,370589,616335540.000000
2023-06-20,Nasdaq BX Options (T),1006720,160926,166563678.000000,0,0,0.000000,1006720,160926,166563678.000000
2023-06-20,Cboe C2 Options Exchange (W),1488589,203049,340402699.000000,15729,3456,21799815.000000,1504318,206505,362202514.000000
2023-06-20,Nasdaq PHLX (X),3813217,276982,1989226372.000000,15983,7121,130522793.000000,3829200,284103,2119749165.000000
2023-06-20,Cboe BZX Options Exchange (Z),1955827,288321,499593775.000000,1906,678,6273885.000000,1957733,288999,505867660.000000
2023-06-16,NYSE American Options (A),3203170,281753,1021972921.000000,0,0,0.000000,3203170,281753,1021972921.000000
2023-06-16,BOX Options (B),3104921,320234,833689191.000000,0,0,0.000000,3104921,320234,833689191.000000
2023-06-16,Cboe Options Exchange (C),4995714,700105,1427996227.000000,4228556,582667,11101457554.000000,9224270,1282772,12529453781.000000
2023-06-16,MIAX Emerald (D),1437282,233144,405277723.000000,0,0,0.000000,1437282,233144,405277723.000000
2023-06-16,Cboe EDGX Options Exchange (E),2870000,414699,600992697.000000,0,0,0.000000,2870000,414699,600992697.000000
2023-06-16,Nasdaq GEMX (H),1389293,185926,275685646.000000,6448,1123,240890187.000000,1395741,187049,516575833.000000
2023-06-16,Nasdaq ISE (I),3188548,385194,1294598445.000000,12665,4660,227467860.000000,3201213,389854,1522066305.000000
2023-06-16,Nasdaq MRX (J),898343,125658,196666768.000000,0,0,0.000000,898343,125658,196666768.000000
2023-06-16,MIAX Options Exchange (M),3075530,480092,855506077.000000,25,1,302375.000000,3075555,480093,855808452.000000
2023-06-16,NYSE Arca Options (N),5710598,757555,1542162868.000000,0,0,0.000000,5710598,757555,1542162868.000000
2023-06-16,MIAX Pearl (P),3080055,324995,586714527.000000,0,0,0.000000,3080055,324995,586714527.000000
2023-06-16,NASDAQ Options Market (Q),2867326,441680,688792967.000000,0,0,0.000000,2867326,441680,688792967.000000
2023-06-16,Nasdaq BX Options (T),1317065,184558,242931945.000000,0,0,0.000000,1317065,184558,242931945.000000
2023-06-16,Cboe C2 Options Exchange (W),1932672,226526,358592205.000000,10481,2906,12580836.000000,1943153,229432,371173041.000000
2023-06-16,Nasdaq PHLX (X),5042513,295801,1362499952.000000,12692,4881,270721982.000000,5055205,300682,1633221934.000000
2023-06-16,Cboe BZX Options Exchange (Z),2612179,353114,616017344.000000,9936,1525,39365974.000000,2622115,354639,655383318.000000
2023-06-15,NYSE American Options (A),3184159,272644,983147409.000000,0,0,0.000000,3184159,272644,983147409.000000
2023-06-15,BOX Options (B),3404267,332237,1808128436.000000,0,0,0.000000,3404267,332237,1808128436.000000
2023-06-15,Cboe Options Exchange (C),5199700,660723,1959172156.000000,4977595,679069,12828279019.000000,10177295,1339792,14787451175.000000
2023-06-15,MIAX Emerald (D),1493919,230481,457511380.000000,0,0,0.000000,1493919,230481,457511380.000000
2023-06-15,Cboe EDGX Options Exchange (E),2850955,420273,666651020.000000,0,0,0.000000,2850955,420273,666651020.000000
2023-06-15,Nasdaq GEMX (H),1369235,181238,311491393.000000,5400,1114,557779625.000000,1374635,182352,869271018.000000
2023-06-15,Nasdaq ISE (I),3190698,367011,1522733510.000000,24808,9748,676770146.000000,3215506,376759,2199503656.000000
2023-06-15,Nasdaq MRX (J),921802,126145,238148111.000000,0,0,0.000000,921802,126145,238148111.000000
2023-06-15,MIAX Options Exchange (M),3216297,480817,900766219.000000,1,1,55.000000,3216298,480818,900766274.000000
2023-06-15,NYSE Arca Options (N),6167169,776467,1836975636.000000,0,0,0.000000,6167169,776467,1836975636.000000
2023-06-15,MIAX Pearl (P),3394641,343520,676629325.000000,0,0,0.000000,3394641,343520,676629325.000000
2023-06-15,NASDAQ Options Market (Q),3039588,451622,807645892.000000,0,0,0.000000,3039588,451622,807645892.000000
2023-06-15,Nasdaq BX Options (T),1381006,188400,232369205.000000,0,0,0.000000,1381006,188400,232369205.000000
2023-06-15,Cboe C2 Options Exchange (W),2140932,247943,475126761.000000,9377,3107,13259499.000000,2150309,251050,488386260.000000
2023-06-15,Nasdaq PHLX (X),5519979,300187,3398287810.000000,24698,10349,509580463.000000,5544677,310536,3907868273.000000
2023-06-15,Cboe BZX Options Exchange (Z),2655370,351846,633178959.000000,2038,539,4055924.000000,2657408,352385,637234883.000000
2023-06-14,NYSE American Options (A),2496151,252136,880724663.000000,0,0,0.000000,2496151,252136,880724663.000000
2023-06-14,BOX Options (B),3440255,293887,2144779479.000000,0,0,0.000000,3440255,293887,2144779479.000000
2023-06-14,Cboe Options Exchange (C),5388399,634645,2727345244.000000,3628307,510770,8282969126.000000,9016706,1145415,11010314370.000000
2023-06-14,MIAX Emerald (D),1277105,210010,404146977.000000,0,0,0.000000,1277105,210010,404146977.000000
2023-06-14,Cboe EDGX Options Exchange (E),2491198,372759,583120202.000000,0,0,0.000000,2491198,372759,583120202.000000
2023-06-14,Nasdaq GEMX (H),1218997,173721,277052463.000000,810,422,29205444.000000,1219807,174143,306257907.000000
2023-06-14,Nasdaq ISE (I),2665256,322253,1282124996.000000,18648,7332,568167888.000000,2683904,329585,1850292884.000000
2023-06-14,Nasdaq MRX (J),792601,122163,216865322.000000,0,0,0.000000,792601,122163,216865322.000000
2023-06-14,MIAX Options Exchange (M),2910288,446957,834465034.000000,2,2,456.000000,2910290,446959,834465490.000000
2023-06-14,NYSE Arca Options (N),5436936,715356,1712741175.000000,1,1,520.000000,5436937,715357,1712741695.000000
2023-06-14,MIAX Pearl (P),3068420,313763,626625186.000000,0,0,0.000000,3068420,313763,626625186.000000
2023-06-14,NASDAQ Options Market (Q),2790659,403904,685859821.000000,0,0,0.000000,2790659,403904,685859821.000000
2023-06-14,Nasdaq BX Options (T),1276357,179216,208762492.000000,0,0,0.000000,1276357,179216,208762492.000000
2023-06-14,Cboe C2 Options Exchange (W),1682857,201158,340671794.000000,9910,3025,15299061.000000,1692767,204183,355970855.000000
2023-06-14,Nasdaq PHLX (X),5827609,288657,4154264718.000000,16710,7383,228234241.000000,5844319,296040,4382498959.000000
2023-06-14,Cboe BZX Options Exchange (Z),2395638,330704,589996610.000000,3228,584,7113552.000000,2398866,331288,597110162.000000
2023-06-13,NYSE American Options (A),2955532,268166,798869727.000000,0,0,0.000000,2955532,268166,798869727.000000
2023-06-13,BOX Options (B),3017897,306602,1303457857.000000,0,0,0.000000,3017897,306602,1303457857.000000
2023-06-13,Cboe Options Exchange (C),4635507,649837,1523128728.000000,4171650,610974,8883015464.000000,8807157,1260811,10406144192.000000
2023-06-13,MIAX Emerald (D),1205274,210808,372110089.000000,0,0,0.000000,1205274,210808,372110089.000000
2023-06-13,Cboe EDGX Options Exchange (E),2561672,380772,649168204.000000,0,0,0.000000,2561672,380772,649168204.000000
2023-06-13,Nasdaq GEMX (H),1234914,172894,284207898.000000,1375,571,24762518.000000,1236289,173465,308970416.000000
2023-06-13,Nasdaq ISE (I),2562312,321804,1222873104.500000,21270,8048,230567685.000000,2583582,329852,1453440789.500000
2023-06-13,Nasdaq MRX (J),802725,120371,198316756.000000,0,0,0.000000,802725,120371,198316756.000000
2023-06-13,MIAX Options Exchange (M),2903682,448845,826752559.000000,1,1,57.000000,2903683,448846,826752616.000000
2023-06-13,NYSE Arca Options (N),5447220,680467,1782360256.000000,1,1,560.000000,5447221,680468,1782360816.000000
2023-06-13,MIAX Pearl (P),2953741,314819,635082532.000000,0,0,0.000000,2953741,314819,635082532.000000
2023-06-13,NASDAQ Options Market (Q),2635712,399731,730164750.000000,0,0,0.000000,2635712,399731,730164750.000000
2023-06-13,Nasdaq BX Options (T),1221162,181067,210201305.000000,0,0,0.000000,1221162,181067,210201305.000000
2023-06-13,Cboe C2 Options Exchange (W),1676051,202019,342976149.000000,8238,2404,13648348.000000,1684289,204423,356624497.000000
2023-06-13,Nasdaq PHLX (X),5296540,283885,2009752933.000000,20120,7905,208519828.000000,5316660,291790,2218272761.000000
2023-06-13,Cboe BZX Options Exchange (Z),2486091,348263,626659873.000000,3866,640,7828449.000000,2489957,348903,634488322.000000
2023-06-12,NYSE American Options (A),2527769,222200,740309330.000000,0,0,0.000000,2527769,222200,740309330.000000
2023-06-12,BOX Options (B),2834831,285020,1387173924.000000,0,0,0.000000,2834831,285020,1387173924.000000
2023-06-12,Cboe Options Exchange (C),4274501,566254,1237185901.000000,3818100,552528,9330699097.000000,8092601,1118782,10567884998.000000
2023-06-12,MIAX Emerald (D),1128241,189968,319083353.000000,0,0,0.000000,1128241,189968,319083353.000000
2023-06-12,Cboe EDGX Options Exchange (E),2149387,333672,473068626.000000,0,0,0.000000,2149387,333672,473068626.000000
2023-06-12,Nasdaq GEMX (H),991560,138313,239243708.000000,291,144,3437716.000000,991851,138457,242681424.000000
2023-06-12,Nasdaq ISE (I),2309101,282060,876841443.000000,21840,8048,242831229.000000,2330941,290108,1119672672.000000
2023-06-12,Nasdaq MRX (J),672892,100741,154547063.000000,0,0,0.000000,672892,100741,154547063.000000
2023-06-12,MIAX Options Exchange (M),2574888,393818,646902501.000000,0,0,0.000000,2574888,393818,646902501.000000
2023-06-12,NYSE Arca Options (N),4317220,590939,1183394614.000000,1,1,570.000000,4317221,590940,1183395184.000000
2023-06-12,MIAX Pearl (P),2527876,266577,521338133.000000,0,0,0.000000,2527876,266577,521338133.000000
2023-06-12,NASDAQ Options Market (Q),2310783,353511,614347909.000000,0,0,0.000000,2310783,353511,614347909.000000
2023-06-12,Nasdaq BX Options (T),985221,150322,168157309.000000,0,0,0.000000,985221,150322,168157309.000000
2023-06-12,Cboe C2 Options Exchange (W),1562777,184301,290741217.000000,9942,2706,12098939.000000,1572719,187007,302840156.000000
2023-06-12,Nasdaq PHLX (X),5944795,259804,2391771367.000000,18368,7328,169264585.000000,5963163,267132,2561035952.000000
2023-06-12,Cboe BZX Options Exchange (Z),2123227,300851,508205825.000000,2133,385,3605053.000000,2125360,301236,511810878.000000
2023-06-09,NYSE American Options (A),2525257,277664,646133006.000000,0,0,0.000000,2525257,277664,646133006.000000
2023-06-09,BOX Options (B),3180793,313436,1324460914.000000,0,0,0.000000,3180793,313436,1324460914.000000
2023-06-09,Cboe Options Exchange (C),4887740,663637,1511735799.000000,4136702,633645,8111385607.000000,9024442,1297282,9623121406.000000
2023-06-09,MIAX Emerald (D),1461694,235089,403195050.000000,0,0,0.000000,1461694,235089,403195050.000000
2023-06-09,Cboe EDGX Options Exchange (E),2786550,419959,610981791.000000,0,0,0.000000,2786550,419959,610981791.000000
2023-06-09,Nasdaq GEMX (H),1353320,181923,278899916.000000,810,251,6558921.000000,1354130,182174,285458837.000000
2023-06-09,Nasdaq ISE (I),2899762,350690,1076616840.000000,26815,9511,166669508.000000,2926577,360201,1243286348.000000
2023-06-09,Nasdaq MRX (J),829290,120731,185938744.000000,0,0,0.000000,829290,120731,185938744.000000
2023-06-09,MIAX Options Exchange (M),3290412,486051,837503107.000000,0,0,0.000000,3290412,486051,837503107.000000
2023-06-09,NYSE Arca Options (N),5584423,714352,1485124727.000000,0,0,0.000000,5584423,714352,1485124727.000000
2023-06-09,MIAX Pearl (P),3301498,348529,600590062.000000,0,0,0.000000,3301498,348529,600590062.000000
2023-06-09,NASDAQ Options Market (Q),2894845,449868,716702673.000000,0,0,0.000000,2894845,449868,716702673.000000
2023-06-09,Nasdaq BX Options (T),1289095,187817,205570708.000000,0,0,0.000000,1289095,187817,205570708.000000
2023-06-09,Cboe C2 Options Exchange (W),1950845,238235,406538037.000000,13914,3158,20331754.000000,1964759,241393,426869791.000000
2023-06-09,Nasdaq PHLX (X),4787471,286998,1400128547.000000,18261,7613,152651542.000000,4805732,294611,1552780089.000000
2023-06-09,Cboe BZX Options Exchange (Z),2808826,375066,639368792.000000,1029,247,2001530.000000,2809855,375313,641370322.000000
2023-06-08,NYSE American Options (A),2912055,232748,693260688.000000,0,0,0.000000,2912055,232748,693260688.000000
2023-06-08,BOX Options (B),2635779,263518,1137043786.000000,0,0,0.000000,2635779,263518,1137043786.000000
2023-06-08,Cboe Options Exchange (C),4426806,570270,1116928592.000000,3826194,551638,5588094102.000000,8253000,1121908,6705022694.000000
2023-06-08,MIAX Emerald (D),1207714,202156,307958489.000000,0,0,0.000000,1207714,202156,307958489.000000
2023-06-08,Cboe EDGX Options Exchange (E),2475922,366649,446344195.000000,0,0,0.000000,2475922,366649,446344195.000000
2023-06-08,Nasdaq GEMX (H),1149152,160360,213962059.000000,644,338,11105406.000000,1149796,160698,225067465.000000
2023-06-08,Nasdaq ISE (I),2346999,273009,739437731.500000,18026,8000,92686546.000000,2365025,281009,832124277.500000
2023-06-08,Nasdaq MRX (J),679850,100258,131706234.000000,0,0,0.000000,679850,100258,131706234.000000
2023-06-08,MIAX Options Exchange (M),2606182,386948,552039331.000000,11,3,420.000000,2606193,386951,552039751.000000
2023-06-08,NYSE Arca Options (N),4717826,620633,1192911622.000000,0,0,0.000000,4717826,620633,1192911622.000000
2023-06-08,MIAX Pearl (P),2804572,300959,502199191.000000,0,0,0.000000,2804572,300959,502199191.000000
2023-06-08,NASDAQ Options Market (Q),2396502,366118,562038686.000000,0,0,0.000000,2396502,366118,562038686.000000
2023-06-08,Nasdaq BX Options (T),1148903,168538,161130486.000000,0,0,0.000000,1148903,168538,161130486.000000
2023-06-08,Cboe C2 Options Exchange (W),1672656,201191,261313852.000000,11813,2944,21690580.000000,1684469,204135,283004432.000000
2023-06-08,Nasdaq PHLX (X),4595435,258740,1734064164.000000,28043,7633,96257899.000000,4623478,266373,1830322063.000000
2023-06-08,Cboe BZX Options Exchange (Z),2289026,319627,477394856.000000,4181,800,8937780.000000,2293207,320427,486332636.000000