Day,Market Participant,Equity Option Contracts,Equity Option Trade Count,Equity Option Notional,Index/Other Option Contracts,Index/Other Option Trade Count,Index/Other Option Notional,Total Option Contracts,Total Trade Count,Total Option Notional
2023-10-12,NYSE American Options (A),2679098,265198,621418299.000000,0,0,0.000000,2679098,265198,621418299.000000
2023-10-12,BOX Options (B),3124831,318899,1732789258.000000,0,0,0.000000,3124831,318899,1732789258.000000
2023-10-12,Cboe Options Exchange (C),4363472,542541,1854057028.000000,4833904,721214,5951256228.000000,9197376,1263755,7805313256.000000
2023-10-12,MIAX Emerald (D),1032789,164321,225528296.000000,0,0,0.000000,1032789,164321,225528296.000000
2023-10-12,Cboe EDGX Options Exchange (E),2757216,392797,434362404.000000,0,0,0.000000,2757216,392797,434362404.000000
2023-10-12,Nasdaq GEMX (H),1231163,146887,255694750.000000,801,403,8653634.000000,1231964,147290,264348384.000000
2023-10-12,Nasdaq ISE (I),2474365,261038,689483564.000000,26945,10852,144863039.000000,2501310,271890,834346603.000000
2023-10-12,Nasdaq MRX (J),1013506,112536,177004463.000000,0,0,0.000000,1013506,112536,177004463.000000
2023-10-12,MIAX Options Exchange (M),2383178,325368,472334469.000000,0,0,0.000000,2383178,325368,472334469.000000
2023-10-12,NYSE Arca Options (N),5195497,617472,1282136652.000000,2,1,3800.000000,5195499,617473,1282140452.000000
2023-10-12,MIAX Pearl (P),2659412,270699,482746020.000000,0,0,0.000000,2659412,270699,482746020.000000
2023-10-12,NASDAQ Options Market (Q),2335899,323706,544726998.000000,0,0,0.000000,2335899,323706,544726998.000000
2023-10-12,Nasdaq BX Options (T),1162314,131223,172846816.000000,0,0,0.000000,1162314,131223,172846816.000000
2023-10-12,Members Exchange (U),17259,3994,4009170.000000,0,0,0.000000,17259,3994,4009170.000000
2023-10-12,Cboe C2 Options Exchange (W),1916887,198811,290188558.000000,16852,4160,22043189.000000,1933739,202971,312231747.000000
2023-10-12,Nasdaq PHLX (X),4267309,260962,2177532009.000000,22494,10163,135521762.000000,4289803,271125,2313053771.000000
2023-10-12,Cboe BZX Options Exchange (Z),2548386,329625,555323712.000000,4362,534,11061286.000000,2552748,330159,566384998.000000
2023-10-11,NYSE American Options (A),2097116,230085,469567253.000000,0,0,0.000000,2097116,230085,469567253.000000
2023-10-11,BOX Options (B),2794603,273300,2237818289.000000,0,0,0.000000,2794603,273300,2237818289.000000
2023-10-11,Cboe Options Exchange (C),4113505,443356,2602493723.000000,3667735,602518,5469049189.000000,7781240,1045874,8071542912.000000
2023-10-11,MIAX Emerald (D),827681,137476,188712746.000000,0,0,0.000000,827681,137476,188712746.000000
2023-10-11,Cboe EDGX Options Exchange (E),2240329,342209,351051967.000000,0,0,0.000000,2240329,342209,351051967.000000
2023-10-11,Nasdaq GEMX (H),1043999,127703,193757665.000000,505,188,3474228.000000,1044504,127891,197231893.000000
2023-10-11,Nasdaq ISE (I),1909251,216677,477533587.500000,17801,8097,110470233.000000,1927052,224774,588003820.500000
2023-10-11,Nasdaq MRX (J),803709,96819,128895250.000000,0,0,0.000000,803709,96819,128895250.000000
2023-10-11,MIAX Options Exchange (M),1924443,286438,422956122.000000,24,23,19725.000000,1924467,286461,422975847.000000
2023-10-11,NYSE Arca Options (N),4076294,513453,1006986982.000000,0,0,0.000000,4076294,513453,1006986982.000000
2023-10-11,MIAX Pearl (P),2056879,204758,383821329.000000,0,0,0.000000,2056879,204758,383821329.000000
2023-10-11,NASDAQ Options Market (Q),1910348,273457,464195616.000000,0,0,0.000000,1910348,273457,464195616.000000
2023-10-11,Nasdaq BX Options (T),980094,112615,151800694.000000,0,0,0.000000,980094,112615,151800694.000000
2023-10-11,Members Exchange (U),18100,3930,4815804.000000,0,0,0.000000,18100,3930,4815804.000000
2023-10-11,Cboe C2 Options Exchange (W),1587993,162970,216758166.000000,7827,2660,8552575.000000,1595820,165630,225310741.000000
2023-10-11,Nasdaq PHLX (X),4626343,222424,4753939778.000000,17977,8137,106428226.000000,4644320,230561,4860368004.000000
2023-10-11,Cboe BZX Options Exchange (Z),2040549,272416,462566409.000000,1931,474,3637136.000000,2042480,272890,466203545.000000
2023-10-10,NYSE American Options (A),2538542,248789,580070617.000000,0,0,0.000000,2538542,248789,580070617.000000
2023-10-10,BOX Options (B),2715161,300978,1266625517.000000,0,0,0.000000,2715161,300978,1266625517.000000
2023-10-10,Cboe Options Exchange (C),3690179,501275,1339211834.000000,4450570,690048,6238769238.000000,8140749,1191323,7577981072.000000
2023-10-10,MIAX Emerald (D),931832,142753,196315888.000000,0,0,0.000000,931832,142753,196315888.000000
2023-10-10,Cboe EDGX Options Exchange (E),2493836,367339,437702543.000000,0,0,0.000000,2493836,367339,437702543.000000
2023-10-10,Nasdaq GEMX (H),1068168,129798,217162096.000000,913,443,16556364.000000,1069081,130241,233718460.000000
2023-10-10,Nasdaq ISE (I),2199016,240932,586021635.500000,21701,9378,118122619.000000,2220717,250310,704144254.500000
2023-10-10,Nasdaq MRX (J),910940,108791,166401253.000000,0,0,0.000000,910940,108791,166401253.000000
2023-10-10,MIAX Options Exchange (M),2008478,294872,446573985.000000,0,0,0.000000,2008478,294872,446573985.000000
2023-10-10,NYSE Arca Options (N),4375975,553518,1130599669.000000,0,0,0.000000,4375975,553518,1130599669.000000
2023-10-10,MIAX Pearl (P),2259348,236459,450006959.000000,0,0,0.000000,2259348,236459,450006959.000000
2023-10-10,NASDAQ Options Market (Q),2046130,292940,521346205.000000,0,0,0.000000,2046130,292940,521346205.000000
2023-10-10,Nasdaq BX Options (T),1070097,125056,176114062.000000,0,0,0.000000,1070097,125056,176114062.000000
2023-10-10,Members Exchange (U),14907,3504,4010703.000000,0,0,0.000000,14907,3504,4010703.000000
2023-10-10,Cboe C2 Options Exchange (W),1685473,181884,284890967.000000,11216,3242,22608047.000000,1696689,185126,307499014.000000
2023-10-10,Nasdaq PHLX (X),4320567,235983,1678177147.000000,23604,9546,193295726.000000,4344171,245529,1871472873.000000
2023-10-10,Cboe BZX Options Exchange (Z),2357067,309171,536136860.000000,6014,759,9623474.000000,2363081,309930,545760334.000000
2023-10-09,NYSE American Options (A),2044982,201198,468774179.000000,0,0,0.000000,2044982,201198,468774179.000000
2023-10-09,BOX Options (B),2241197,248379,1168293515.000000,0,0,0.000000,2241197,248379,1168293515.000000
2023-10-09,Cboe Options Exchange (C),3205633,429832,1331242419.000000,3974640,618659,4960579631.000000,7180273,1048491,6291822050.000000
2023-10-09,MIAX Emerald (D),717477,118610,168270750.000000,0,0,0.000000,717477,118610,168270750.000000
2023-10-09,Cboe EDGX Options Exchange (E),2022018,295834,357709712.000000,0,0,0.000000,2022018,295834,357709712.000000
2023-10-09,Nasdaq GEMX (H),894093,107095,185230111.000000,673,296,9489484.000000,894766,107391,194719595.000000
2023-10-09,Nasdaq ISE (I),1761618,209903,469778555.000000,19384,9300,89339825.500000,1781002,219203,559118380.500000
2023-10-09,Nasdaq MRX (J),682956,84765,126685131.000000,0,0,0.000000,682956,84765,126685131.000000
2023-10-09,MIAX Options Exchange (M),1722296,256447,379555399.000000,0,0,0.000000,1722296,256447,379555399.000000
2023-10-09,NYSE Arca Options (N),3522906,448451,954775354.000000,0,0,0.000000,3522906,448451,954775354.000000
2023-10-09,MIAX Pearl (P),1927484,189526,393375788.000000,0,0,0.000000,1927484,189526,393375788.000000
2023-10-09,NASDAQ Options Market (Q),1782659,267066,463819893.000000,0,0,0.000000,1782659,267066,463819893.000000
2023-10-09,Nasdaq BX Options (T),893106,102102,154067171.000000,0,0,0.000000,893106,102102,154067171.000000
2023-10-09,Members Exchange (U),9024,1275,1156179.000000,0,0,0.000000,9024,1275,1156179.000000
2023-10-09,Cboe C2 Options Exchange (W),1461104,173018,256359807.000000,10320,3291,14639328.000000,1471424,176309,270999135.000000
2023-10-09,Nasdaq PHLX (X),3007296,191940,1614100135.000000,17805,8382,139046081.000000,3025101,200322,1753146216.000000
2023-10-09,Cboe BZX Options Exchange (Z),1924438,249379,456782131.000000,1926,514,3737417.000000,1926364,249893,460519548.000000
2023-10-06,NYSE American Options (A),2784388,285889,594173228.000000,0,0,0.000000,2784388,285889,594173228.000000
2023-10-06,BOX Options (B),3013678,344537,592730589.000000,0,0,0.000000,3013678,344537,592730589.000000
2023-10-06,Cboe Options Exchange (C),4175562,612757,911429454.000000,5187342,814958,8216418795.000000,9362904,1427715,9127848249.000000
2023-10-06,MIAX Emerald (D),1238962,195287,249248748.000000,0,0,0.000000,1238962,195287,249248748.000000
2023-10-06,Cboe EDGX Options Exchange (E),3316115,445572,518775598.000000,0,0,0.000000,3316115,445572,518775598.000000
2023-10-06,Nasdaq GEMX (H),1425126,158941,245669353.000000,3535,410,13192683.000000,1428661,159351,258862036.000000
2023-10-06,Nasdaq ISE (I),3036751,340634,865439141.000000,31225,13099,174903652.500000,3067976,353733,1040342793.500000
2023-10-06,Nasdaq MRX (J),1117582,127581,182284472.000000,0,0,0.000000,1117582,127581,182284472.000000
2023-10-06,MIAX Options Exchange (M),3215618,462752,607932316.000000,0,0,0.000000,3215618,462752,607932316.000000
2023-10-06,NYSE Arca Options (N),5662715,679229,1373769013.000000,0,0,0.000000,5662715,679229,1373769013.000000
2023-10-06,MIAX Pearl (P),3176653,304453,589644964.000000,0,0,0.000000,3176653,304453,589644964.000000
2023-10-06,NASDAQ Options Market (Q),2667063,363932,643417048.000000,0,0,0.000000,2667063,363932,643417048.000000
2023-10-06,Nasdaq BX Options (T),1391927,147866,218245852.000000,0,0,0.000000,1391927,147866,218245852.000000
2023-10-06,Members Exchange (U),9815,1609,1508605.000000,0,0,0.000000,9815,1609,1508605.000000
2023-10-06,Cboe C2 Options Exchange (W),2309986,257661,433752058.000000,14631,4129,26146937.000000,2324617,261790,459898995.000000
2023-10-06,Nasdaq PHLX (X),4078989,260888,789920347.000000,28062,12162,241023851.000000,4107051,273050,1030944198.000000
2023-10-06,Cboe BZX Options Exchange (Z),2913945,350948,573538273.000000,967,202,3862960.000000,2914912,351150,577401233.000000
2023-10-05,NYSE American Options (A),2461933,220578,626294363.000000,0,0,0.000000,2461933,220578,626294363.000000
2023-10-05,BOX Options (B),2718336,278258,1852010798.000000,0,0,0.000000,2718336,278258,1852010798.000000
2023-10-05,Cboe Options Exchange (C),3335606,417075,1444305636.000000,4018584,635444,5606412093.000000,7354190,1052519,7050717729.000000
2023-10-05,MIAX Emerald (D),849486,139023,178419182.000000,0,0,0.000000,849486,139023,178419182.000000
2023-10-05,Cboe EDGX Options Exchange (E),2351798,336394,361803220.000000,0,0,0.000000,2351798,336394,361803220.000000
2023-10-05,Nasdaq GEMX (H),1026189,125379,175609738.000000,5043,557,14312489.000000,1031232,125936,189922227.000000
2023-10-05,Nasdaq ISE (I),1987441,220661,511714899.000000,19993,9046,82627815.000000,2007434,229707,594342714.000000
2023-10-05,Nasdaq MRX (J),745714,95782,123103180.000000,0,0,0.000000,745714,95782,123103180.000000
2023-10-05,MIAX Options Exchange (M),2234877,319345,423186533.000000,0,0,0.000000,2234877,319345,423186533.000000
2023-10-05,NYSE Arca Options (N),4244683,521223,1060610231.000000,0,0,0.000000,4244683,521223,1060610231.000000
2023-10-05,MIAX Pearl (P),2186751,236898,463740792.000000,0,0,0.000000,2186751,236898,463740792.000000
2023-10-05,NASDAQ Options Market (Q),1896389,269553,489434957.000000,0,0,0.000000,1896389,269553,489434957.000000
2023-10-05,Nasdaq BX Options (T),920354,109974,144187948.000000,0,0,0.000000,920354,109974,144187948.000000
2023-10-05,Members Exchange (U),9166,1410,1485400.000000,0,0,0.000000,9166,1410,1485400.000000
2023-10-05,Cboe C2 Options Exchange (W),1653259,192015,338910956.000000,8037,2318,14931018.000000,1661296,194333,353841974.000000
2023-10-05,Nasdaq PHLX (X),4015294,206229,2652890948.000000,19924,9726,123549641.000000,4035218,215955,2776440589.000000
2023-10-05,Cboe BZX Options Exchange (Z),2143543,279286,445649436.000000,826,180,2937180.000000,2144369,279466,448586616.000000
2023-10-04,NYSE American Options (A),2553998,228661,621435387.000000,0,0,0.000000,2553998,228661,621435387.000000
2023-10-04,BOX Options (B),3728354,290607,3602059780.000000,0,0,0.000000,3728354,290607,3602059780.000000
2023-10-04,Cboe Options Exchange (C),4977407,484196,3795773060.000000,4348018,710241,8400375368.000000,9325425,1194437,12196148428.000000
2023-10-04,MIAX Emerald (D),920951,146735,202473032.000000,0,0,0.000000,920951,146735,202473032.000000
2023-10-04,Cboe EDGX Options Exchange (E),2425228,353371,438339645.000000,0,0,0.000000,2425228,353371,438339645.000000
2023-10-04,Nasdaq GEMX (H),1023713,125097,199853375.000000,3144,534,23114474.000000,1026857,125631,222967849.000000
2023-10-04,Nasdaq ISE (I),2245366,226053,632932797.000000,21885,9373,125598281.500000,2267251,235426,758531078.500000
2023-10-04,Nasdaq MRX (J),794472,94972,144566006.000000,0,0,0.000000,794472,94972,144566006.000000
2023-10-04,MIAX Options Exchange (M),2017295,284616,405804794.000000,0,0,0.000000,2017295,284616,405804794.000000
2023-10-04,NYSE Arca Options (N),4897263,557837,1216468025.000000,0,0,0.000000,4897263,557837,1216468025.000000
2023-10-04,MIAX Pearl (P),2358715,241921,464454626.000000,0,0,0.000000,2358715,241921,464454626.000000
2023-10-04,NASDAQ Options Market (Q),2106336,298886,519323089.000000,0,0,0.000000,2106336,298886,519323089.000000
2023-10-04,Nasdaq BX Options (T),1024611,138628,167993015.000000,0,0,0.000000,1024611,138628,167993015.000000
2023-10-04,Members Exchange (U),5446,902,1498782.000000,0,0,0.000000,5446,902,1498782.000000
2023-10-04,Cboe C2 Options Exchange (W),1831171,202814,399210412.000000,14077,3940,30628971.000000,1845248,206754,429839383.000000
2023-10-04,Nasdaq PHLX (X),6131099,216900,7787709515.000000,16831,8581,109059609.000000,6147930,225481,7896769124.000000
2023-10-04,Cboe BZX Options Exchange (Z),2353581,297919,489920156.000000,4261,537,14165815.000000,2357842,298456,504085971.000000
2023-10-03,NYSE American Options (A),2617025,247768,650962503.000000,0,0,0.000000,2617025,247768,650962503.000000
2023-10-03,BOX Options (B),3203019,295669,1885993824.000000,0,0,0.000000,3203019,295669,1885993824.000000
2023-10-03,Cboe Options Exchange (C),4696892,552353,1446872800.000000,5189734,740718,10725057336.000000,9886626,1293071,12171930136.000000
2023-10-03,MIAX Emerald (D),911310,150075,205347826.000000,0,0,0.000000,911310,150075,205347826.000000
2023-10-03,Cboe EDGX Options Exchange (E),2625206,362953,527912769.000000,0,0,0.000000,2625206,362953,527912769.000000
2023-10-03,Nasdaq GEMX (H),1080338,127239,221164684.000000,688,303,11170098.000000,1081026,127542,232334782.000000
2023-10-03,Nasdaq ISE (I),2403776,254644,692943972.000000,22087,9144,128686390.500000,2425863,263788,821630362.500000
2023-10-03,Nasdaq MRX (J),871640,101711,181035154.000000,0,0,0.000000,871640,101711,181035154.000000
2023-10-03,MIAX Options Exchange (M),2201980,302189,518411927.000000,35,2,48250.000000,2202015,302191,518460177.000000
2023-10-03,NYSE Arca Options (N),5092757,584014,1415559656.000000,0,0,0.000000,5092757,584014,1415559656.000000
2023-10-03,MIAX Pearl (P),2490860,251727,530996588.000000,0,0,0.000000,2490860,251727,530996588.000000
2023-10-03,NASDAQ Options Market (Q),2341488,324078,664046512.000000,0,0,0.000000,2341488,324078,664046512.000000
2023-10-03,Nasdaq BX Options (T),1150479,142921,217134869.000000,0,0,0.000000,1150479,142921,217134869.000000
2023-10-03,Members Exchange (U),2607,344,468916.000000,0,0,0.000000,2607,344,468916.000000
2023-10-03,Cboe C2 Options Exchange (W),1987713,217780,431548885.000000,20644,5713,51441704.000000,2008357,223493,482990589.000000
2023-10-03,Nasdaq PHLX (X),4109994,229384,1897022552.000000,21617,10096,188302835.000000,4131611,239480,2085325387.000000
2023-10-03,Cboe BZX Options Exchange (Z),2400016,309045,582032382.000000,2771,523,6824987.000000,2402787,309568,588857369.000000
2023-10-02,NYSE American Options (A),2147202,231358,499865065.000000,0,0,0.000000,2147202,231358,499865065.000000
2023-10-02,BOX Options (B),2771240,271078,1929128561.000000,0,0,0.000000,2771240,271078,1929128561.000000
2023-10-02,Cboe Options Exchange (C),3775495,511360,1288920752.000000,3705686,651028,6786674724.000000,7481181,1162388,8075595476.000000
2023-10-02,MIAX Emerald (D),902596,156222,204923209.000000,0,0,0.000000,902596,156222,204923209.000000
2023-10-02,Cboe EDGX Options Exchange (E),2165308,340378,388235717.000000,0,0,0.000000,2165308,340378,388235717.000000
2023-10-02,Nasdaq GEMX (H),1023984,127031,198221492.000000,2696,855,30736740.000000,1026680,127886,228958232.000000
2023-10-02,Nasdaq ISE (I),1887750,218141,636575100.000000,19638,8525,116071919.000000,1907388,226666,752647019.000000
2023-10-02,Nasdaq MRX (J),720721,90886,189901328.000000,0,0,0.000000,720721,90886,189901328.000000
2023-10-02,MIAX Options Exchange (M),1898855,291162,410850764.000000,0,0,0.000000,1898855,291162,410850764.000000
2023-10-02,NYSE Arca Options (N),4244574,540492,1168731635.000000,0,0,0.000000,4244574,540492,1168731635.000000
2023-10-02,MIAX Pearl (P),2353691,248594,475185281.000000,0,0,0.000000,2353691,248594,475185281.000000
2023-10-02,NASDAQ Options Market (Q),2040276,284535,518218985.000000,0,0,0.000000,2040276,284535,518218985.000000
2023-10-02,Nasdaq BX Options (T),1015086,131423,179322136.000000,0,0,0.000000,1015086,131423,179322136.000000
2023-10-02,Members Exchange (U),1595,344,316918.000000,0,0,0.000000,1595,344,316918.000000
2023-10-02,Cboe C2 Options Exchange (W),1734575,199963,420009583.000000,17558,4624,33512856.000000,1752133,204587,453522439.000000
2023-10-02,Nasdaq PHLX (X),3525979,228840,1608450603.000000,21810,9252,143890682.000000,3547789,238092,1752341285.000000
2023-10-02,Cboe BZX Options Exchange (Z),2126466,280040,482094656.000000,3984,1533,13515453.000000,2130450,281573,495610109.000000
2023-09-29,NYSE American Options (A),2643751,244501,626427968.000000,0,0,0.000000,2643751,244501,626427968.000000
2023-09-29,BOX Options (B),3192179,315093,1476691423.000000,0,0,0.000000,3192179,315093,1476691423.000000
2023-09-29,Cboe Options Exchange (C),4482274,588479,1302966100.000000,5111318,703862,9885120895.000000,9593592,1292341,11188086995.000000
2023-09-29,MIAX Emerald (D),1296862,206649,276582015.000000,0,0,0.000000,1296862,206649,276582015.000000
2023-09-29,Cboe EDGX Options Exchange (E),2640715,395731,420359296.000000,0,0,0.000000,2640715,395731,420359296.000000
2023-09-29,Nasdaq GEMX (H),1329652,153970,225851831.000000,662,306,15448194.000000,1330314,154276,241300025.000000
2023-09-29,Nasdaq ISE (I),2204522,257145,602225146.000000,27026,11249,161583263.000000,2231548,268394,763808409.000000
2023-09-29,Nasdaq MRX (J),892591,113887,139789901.000000,0,0,0.000000,892591,113887,139789901.000000
2023-09-29,MIAX Options Exchange (M),2711564,388269,565246519.000000,0,0,0.000000,2711564,388269,565246519.000000
2023-09-29,NYSE Arca Options (N),4564551,538396,1106160706.000000,0,0,0.000000,4564551,538396,1106160706.000000
2023-09-29,MIAX Pearl (P),2990300,303831,581995554.000000,0,0,0.000000,2990300,303831,581995554.000000
2023-09-29,NASDAQ Options Market (Q),2438907,344109,562349215.000000,0,0,0.000000,2438907,344109,562349215.000000
2023-09-29,Nasdaq BX Options (T),1433015,200072,264633273.000000,0,0,0.000000,1433015,200072,264633273.000000
2023-09-29,Members Exchange (U),2224,341,329740.000000,0,0,0.000000,2224,341,329740.000000
2023-09-29,Cboe C2 Options Exchange (W),2114556,246153,385574008.000000,12617,3157,15783762.000000,2127173,249310,401357770.000000
2023-09-29,Nasdaq PHLX (X),3782759,254370,1489551790.000000,17029,7648,90609218.000000,3799788,262018,1580161008.000000
2023-09-29,Cboe BZX Options Exchange (Z),2688174,329164,526402318.000000,1217,281,3275375.000000,2689391,329445,529677693.000000
2023-09-28,NYSE American Options (A),2399062,239479,586089436.000000,0,0,0.000000,2399062,239479,586089436.000000
2023-09-28,BOX Options (B),2751545,293848,1311194176.000000,0,0,0.000000,2751545,293848,1311194176.000000
2023-09-28,Cboe Options Exchange (C),3960831,524984,1418524323.000000,4115802,654324,6656078352.000000,8076633,1179308,8074602675.000000
2023-09-28,MIAX Emerald (D),1106820,190425,261633618.000000,0,0,0.000000,1106820,190425,261633618.000000
2023-09-28,Cboe EDGX Options Exchange (E),2397088,370359,418731897.000000,0,0,0.000000,2397088,370359,418731897.000000
2023-09-28,Nasdaq GEMX (H),1093134,140685,209020680.000000,633,211,5495137.000000,1093767,140896,214515817.000000
2023-09-28,Nasdaq ISE (I),1969520,205823,546481920.000000,30568,11607,135373952.000000,2000088,217430,681855872.000000
2023-09-28,Nasdaq MRX (J),793605,97681,137198996.000000,0,0,0.000000,793605,97681,137198996.000000
2023-09-28,MIAX Options Exchange (M),2428070,355104,488694457.000000,0,0,0.000000,2428070,355104,488694457.000000
2023-09-28,NYSE Arca Options (N),4161925,502758,995657994.000000,0,0,0.000000,4161925,502758,995657994.000000
2023-09-28,MIAX Pearl (P),2544024,263459,508627248.000000,0,0,0.000000,2544024,263459,508627248.000000
2023-09-28,NASDAQ Options Market (Q),2109396,296656,528521275.000000,0,0,0.000000,2109396,296656,528521275.000000
2023-09-28,Nasdaq BX Options (T),1251180,182707,226752002.000000,0,0,0.000000,1251180,182707,226752002.000000
2023-09-28,Members Exchange (U),765,195,251646.000000,0,0,0.000000,765,195,251646.000000
2023-09-28,Cboe C2 Options Exchange (W),1738599,208397,325778680.000000,6912,2230,9319524.000000,1745511,210627,335098204.000000
2023-09-28,Nasdaq PHLX (X),3806044,240592,2028929689.000000,25009,10361,130941997.000000,3831053,250953,2159871686.000000
2023-09-28,Cboe BZX Options Exchange (Z),2210240,285893,475396571.000000,749,147,1825709.000000,2210989,286040,477222280.000000
2023-09-27,NYSE American Options (A),2622344,256179,656912954.000000,0,0,0.000000,2622344,256179,656912954.000000
2023-09-27,BOX Options (B),3955801,296934,4039132050.000000,0,0,0.000000,3955801,296934,4039132050.000000
2023-09-27,Cboe Options Exchange (C),4777618,538860,3101541577.000000,4912330,732196,9144206564.000000,9689948,1271056,12245748141.000000
2023-09-27,MIAX Emerald (D),1148048,191540,306055491.000000,0,0,0.000000,1148048,191540,306055491.000000
2023-09-27,Cboe EDGX Options Exchange (E),2695389,377095,485837420.000000,0,0,0.000000,2695389,377095,485837420.000000
2023-09-27,Nasdaq GEMX (H),1224589,143783,245565512.000000,575,192,6913525.000000,1225164,143975,252479037.000000
2023-09-27,Nasdaq ISE (I),1932734,207651,519351436.000000,23961,10365,169930581.000000,1956695,218016,689282017.000000
2023-09-27,Nasdaq MRX (J),811387,102880,150199652.000000,0,0,0.000000,811387,102880,150199652.000000
2023-09-27,MIAX Options Exchange (M),2443457,362496,574993168.000000,2,2,322.000000,2443459,362498,574993490.000000
2023-09-27,NYSE Arca Options (N),4574639,514249,1176052801.000000,0,0,0.000000,4574639,514249,1176052801.000000
2023-09-27,MIAX Pearl (P),2618877,265339,551861439.000000,0,0,0.000000,2618877,265339,551861439.000000
2023-09-27,NASDAQ Options Market (Q),2342138,311940,621660187.000000,0,0,0.000000,2342138,311940,621660187.000000
2023-09-27,Nasdaq BX Options (T),1323389,179900,241610551.000000,0,0,0.000000,1323389,179900,241610551.000000
2023-09-27,Members Exchange (U),724,218,307313.000000,0,0,0.000000,724,218,307313.000000
2023-09-27,Cboe C2 Options Exchange (W),2000203,218423,392610050.000000,11584,2932,20971255.000000,2011787,221355,413581305.000000
2023-09-27,Nasdaq PHLX (X),6124487,244166,8470580072.000000,22608,11111,262821968.000000,6147095,255277,8733402040.000000
2023-09-27,Cboe BZX Options Exchange (Z),2301633,286445,529567497.000000,3645,520,12738142.000000,2305278,286965,542305639.000000
2023-09-26,NYSE American Options (A),2708725,227086,814507820.000000,0,0,0.000000,2708725,227086,814507820.000000
2023-09-26,BOX Options (B),3041486,265333,1851241434.000000,0,0,0.000000,3041486,265333,1851241434.000000
2023-09-26,Cboe Options Exchange (C),4210257,494887,1488097270.600000,4631204,664984,9072057745.000000,8841461,1159871,10560155015.600000
2023-09-26,MIAX Emerald (D),1007167,173590,278089721.000000,0,0,0.000000,1007167,173590,278089721.000000
2023-09-26,Cboe EDGX Options Exchange (E),2420605,346685,493104493.000000,0,0,0.000000,2420605,346685,493104493.000000
2023-09-26,Nasdaq GEMX (H),947570,125084,198752294.000000,1322,276,14406737.000000,948892,125360,213159031.000000
2023-09-26,Nasdaq ISE (I),2148309,195777,727744278.000000,18471,8865,162544403.500000,2166780,204642,890288681.500000
2023-09-26,Nasdaq MRX (J),800858,96320,172678283.000000,0,0,0.000000,800858,96320,172678283.000000
2023-09-26,MIAX Options Exchange (M),2177531,321972,570521620.000000,17,2,1935.000000,2177548,321974,570523555.000000
2023-09-26,NYSE Arca Options (N),4114658,465202,1127110049.000000,0,0,0.000000,4114658,465202,1127110049.000000
2023-09-26,MIAX Pearl (P),2260965,237586,528993033.000000,0,0,0.000000,2260965,237586,528993033.000000
2023-09-26,NASDAQ Options Market (Q),2113450,263747,583125041.000000,0,0,0.000000,2113450,263747,583125041.000000
2023-09-26,Nasdaq BX Options (T),1233252,170619,250575831.000000,0,0,0.000000,1233252,170619,250575831.000000
2023-09-26,Cboe C2 Options Exchange (W),1641979,195803,360779762.000000,11641,3341,27612204.000000,1653620,199144,388391966.000000
2023-09-26,Nasdaq PHLX (X),3950126,218008,1843290633.000000,21294,10607,237411282.000000,3971420,228615,2080701915.000000
2023-09-26,Cboe BZX Options Exchange (Z),1924625,245952,484120718.000000,2519,373,5936230.000000,1927144,246325,490056948.000000
2023-09-25,NYSE American Options (A),2269291,218020,439424929.000000,0,0,0.000000,2269291,218020,439424929.000000
2023-09-25,BOX Options (B),2133715,246643,1323376612.000000,0,0,0.000000,2133715,246643,1323376612.000000
2023-09-25,Cboe Options Exchange (C),3152090,434996,1127105593.000000,3567254,583187,6347117691.000000,6719344,1018183,7474223284.000000
2023-09-25,MIAX Emerald (D),1068511,186994,272777729.000000,0,0,0.000000,1068511,186994,272777729.000000
2023-09-25,Cboe EDGX Options Exchange (E),2142934,319698,396566145.000000,0,0,0.000000,2142934,319698,396566145.000000
2023-09-25,Nasdaq GEMX (H),948711,125853,202974850.000000,315,169,6647178.000000,949026,126022,209622028.000000
2023-09-25,Nasdaq ISE (I),1731848,196018,516371682.000000,17423,7756,145894354.000000,1749271,203774,662266036.000000
2023-09-25,Nasdaq MRX (J),602199,84806,187496222.000000,0,0,0.000000,602199,84806,187496222.000000
2023-09-25,MIAX Options Exchange (M),1797428,273073,385310257.000000,16,2,1712.000000,1797444,273075,385311969.000000
2023-09-25,NYSE Arca Options (N),3347591,429064,871757765.000000,0,0,0.000000,3347591,429064,871757765.000000
2023-09-25,MIAX Pearl (P),2014767,218439,440994060.000000,0,0,0.000000,2014767,218439,440994060.000000
2023-09-25,NASDAQ Options Market (Q),1754245,244896,473979674.000000,0,0,0.000000,1754245,244896,473979674.000000
2023-09-25,Nasdaq BX Options (T),1094046,166299,217373921.000000,0,0,0.000000,1094046,166299,217373921.000000
2023-09-25,Cboe C2 Options Exchange (W),1459103,163139,278787826.000000,9432,2871,12182610.000000,1468535,166010,290970436.000000
2023-09-25,Nasdaq PHLX (X),3316840,213110,1696600857.000000,20649,8962,158297782.000000,3337489,222072,1854898639.000000
2023-09-25,Cboe BZX Options Exchange (Z),1574401,203704,402366140.000000,2741,365,4344661.000000,1577142,204069,406710801.000000
2023-09-22,NYSE American Options (A),2605017,257381,590851253.000000,0,0,0.000000,2605017,257381,590851253.000000
2023-09-22,BOX Options (B),2645500,289123,1283826707.000000,0,0,0.000000,2645500,289123,1283826707.000000
2023-09-22,Cboe Options Exchange (C),4053568,544975,1204432046.000000,4366680,661659,8163642672.000000,8420248,1206634,9368074718.000000
2023-09-22,MIAX Emerald (D),1665829,251552,335948055.000000,0,0,0.000000,1665829,251552,335948055.000000
2023-09-22,Cboe EDGX Options Exchange (E),2778709,397054,428689214.000000,0,0,0.000000,2778709,397054,428689214.000000
2023-09-22,Nasdaq GEMX (H),1321604,165992,248237853.000000,1233,427,27056401.000000,1322837,166419,275294254.000000
2023-09-22,Nasdaq ISE (I),2244554,257529,639207878.000000,23373,9841,174356041.000000,2267927,267370,813563919.000000
2023-09-22,Nasdaq MRX (J),841693,104580,154957316.000000,0,0,0.000000,841693,104580,154957316.000000
2023-09-22,MIAX Options Exchange (M),2609747,365131,497819172.000000,0,0,0.000000,2609747,365131,497819172.000000
2023-09-22,NYSE Arca Options (N),4414278,543618,1026867065.000000,0,0,0.000000,4414278,543618,1026867065.000000
2023-09-22,MIAX Pearl (P),2738489,278660,476309842.000000,0,0,0.000000,2738489,278660,476309842.000000
2023-09-22,NASDAQ Options Market (Q),2323341,308351,537885847.000000,0,0,0.000000,2323341,308351,537885847.000000
2023-09-22,Nasdaq BX Options (T),1476536,194145,236780723.000000,0,0,0.000000,1476536,194145,236780723.000000
2023-09-22,Cboe C2 Options Exchange (W),1965589,222309,337020469.000000,12125,4112,24465444.000000,1977714,226421,361485913.000000
2023-09-22,Nasdaq PHLX (X),4013519,253567,1494334563.000000,26633,10850,176331268.000000,4040152,264417,1670665831.000000
2023-09-22,Cboe BZX Options Exchange (Z),2109081,251629,418948489.000000,6332,960,19719916.000000,2115413,252589,438668405.000000
2023-09-21,NYSE American Options (A),2929942,272988,710121670.000000,0,0,0.000000,2929942,272988,710121670.000000
2023-09-21,BOX Options (B),3039066,302711,1941727387.000000,0,0,0.000000,3039066,302711,1941727387.000000
2023-09-21,Cboe Options Exchange (C),4596083,584789,1532068924.000000,4887881,650101,9662313141.000000,9483964,1234890,11194382065.000000
2023-09-21,MIAX Emerald (D),1669731,262928,418663259.000000,0,0,0.000000,1669731,262928,418663259.000000
2023-09-21,Cboe EDGX Options Exchange (E),2912428,411661,554462213.000000,0,0,0.000000,2912428,411661,554462213.000000
2023-09-21,Nasdaq GEMX (H),1372643,175386,290808851.000000,2116,762,24093675.000000,1374759,176148,314902526.000000
2023-09-21,Nasdaq ISE (I),2659730,292799,825872718.000000,32360,10724,238759890.000000,2692090,303523,1064632608.000000
2023-09-21,Nasdaq MRX (J),881704,114506,185016990.000000,0,0,0.000000,881704,114506,185016990.000000
2023-09-21,MIAX Options Exchange (M),2824586,382207,625112935.000000,26,2,18920.000000,2824612,382209,625131855.000000
2023-09-21,NYSE Arca Options (N),4839438,576758,1320100765.000000,0,0,0.000000,4839438,576758,1320100765.000000
2023-09-21,MIAX Pearl (P),2765904,289057,577991538.000000,0,0,0.000000,2765904,289057,577991538.000000
2023-09-21,NASDAQ Options Market (Q),2456659,337677,661203661.000000,0,0,0.000000,2456659,337677,661203661.000000
2023-09-21,Nasdaq BX Options (T),1476558,190628,272731877.000000,0,0,0.000000,1476558,190628,272731877.000000
2023-09-21,Cboe C2 Options Exchange (W),2011433,236294,388085830.000000,19224,5285,48880741.000000,2030657,241579,436966571.000000
2023-09-21,Nasdaq PHLX (X),4423487,285863,1858470694.000000,30270,11946,244299777.000000,4453757,297809,2102770471.000000
2023-09-21,Cboe BZX Options Exchange (Z),2107010,261402,514359650.000000,3073,493,6698473.000000,2110083,261895,521058123.000000
2023-09-20,NYSE American Options (A),2133345,225571,502526949.000000,0,0,0.000000,2133345,225571,502526949.000000
2023-09-20,BOX Options (B),2458439,239592,1638834767.000000,0,0,0.000000,2458439,239592,1638834767.000000
2023-09-20,Cboe Options Exchange (C),3422278,436483,1592322202.000000,3386144,496345,4924413430.000000,6808422,932828,6516735632.000000
2023-09-20,MIAX Emerald (D),1327428,216725,300935908.000000,0,0,0.000000,1327428,216725,300935908.000000
2023-09-20,Cboe EDGX Options Exchange (E),2088341,327156,343286002.000000,0,0,0.000000,2088341,327156,343286002.000000
2023-09-20,Nasdaq GEMX (H),1065763,146075,200488467.000000,1025,417,11664825.000000,1066788,146492,212153292.000000
2023-09-20,Nasdaq ISE (I),1756468,202964,541190248.000000,19496,7266,156192506.000000,1775964,210230,697382754.000000
2023-09-20,Nasdaq MRX (J),649077,86331,114527253.000000,0,0,0.000000,649077,86331,114527253.000000
2023-09-20,MIAX Options Exchange (M),2048244,298291,411341343.000000,1,1,200.000000,2048245,298292,411341543.000000
2023-09-20,NYSE Arca Options (N),3643302,472458,859988282.000000,0,0,0.000000,3643302,472458,859988282.000000
2023-09-20,MIAX Pearl (P),2189496,243010,396273339.000000,0,0,0.000000,2189496,243010,396273339.000000
2023-09-20,NASDAQ Options Market (Q),1927840,275897,456072869.000000,0,0,0.000000,1927840,275897,456072869.000000
2023-09-20,Nasdaq BX Options (T),1167468,162299,207131598.000000,0,0,0.000000,1167468,162299,207131598.000000
2023-09-20,Cboe C2 Options Exchange (W),1493957,168342,332568705.000000,9681,3285,15072592.000000,1503638,171627,347641297.000000
2023-09-20,Nasdaq PHLX (X),4122489,223232,3078219323.000000,20752,8767,137144359.000000,4143241,231999,3215363682.000000
2023-09-20,Cboe BZX Options Exchange (Z),1763966,232140,377085881.000000,925,155,1378851.000000,1764891,232295,378464732.000000
2023-09-19,NYSE American Options (A),2644262,224579,579725606.000000,0,0,0.000000,2644262,224579,579725606.000000
2023-09-19,BOX Options (B),2505770,254625,1305135368.000000,0,0,0.000000,2505770,254625,1305135368.000000
2023-09-19,Cboe Options Exchange (C),3349422,430191,1225505590.000000,4361969,600732,5767458362.000000,7711391,1030923,6992963952.000000
2023-09-19,MIAX Emerald (D),1036913,173902,257791565.000000,0,0,0.000000,1036913,173902,257791565.000000
2023-09-19,Cboe EDGX Options Exchange (E),2159439,322865,352733213.000000,0,0,0.000000,2159439,322865,352733213.000000
2023-09-19,Nasdaq GEMX (H),1055383,133710,196239587.000000,455,174,4418723.000000,1055838,133884,200658310.000000
2023-09-19,Nasdaq ISE (I),1634115,195130,568968406.000000,24206,9442,114851171.000000,1658321,204572,683819577.000000
2023-09-19,Nasdaq MRX (J),655271,82658,142999828.000000,0,0,0.000000,655271,82658,142999828.000000
2023-09-19,MIAX Options Exchange (M),1898088,281998,382607033.000000,0,0,0.000000,1898088,281998,382607033.000000
2023-09-19,NYSE Arca Options (N),3729634,474807,954971068.000000,0,0,0.000000,3729634,474807,954971068.000000
2023-09-19,MIAX Pearl (P),2064824,226690,400706976.000000,0,0,0.000000,2064824,226690,400706976.000000
2023-09-19,NASDAQ Options Market (Q),1864053,252753,442516718.000000,0,0,0.000000,1864053,252753,442516718.000000
2023-09-19,Nasdaq BX Options (T),1254621,160709,241692001.000000,0,0,0.000000,1254621,160709,241692001.000000
2023-09-19,Cboe C2 Options Exchange (W),1493687,168741,370876809.000000,8372,2476,16167829.000000,1502059,171217,387044638.000000
2023-09-19,Nasdaq PHLX (X),3184508,220626,1558261339.000000,24992,10364,152886918.000000,3209500,230990,1711148257.000000
2023-09-19,Cboe BZX Options Exchange (Z),1619710,214090,361936941.000000,1462,275,4150270.000000,1621172,214365,366087211.000000
2023-09-18,NYSE American Options (A),2435418,223758,615641974.000000,0,0,0.000000,2435418,223758,615641974.000000
2023-09-18,BOX Options (B),1999688,260273,711084641.000000,0,0,0.000000,1999688,260273,711084641.000000
2023-09-18,Cboe Options Exchange (C),3271612,431297,1113564835.000000,3074716,502783,4650515646.000000,6346328,934080,5764080481.000000
2023-09-18,MIAX Emerald (D),833055,156890,199743958.000000,0,0,0.000000,833055,156890,199743958.000000
2023-09-18,Cboe EDGX Options Exchange (E),2019659,322458,311039148.000000,0,0,0.000000,2019659,322458,311039148.000000
2023-09-18,Nasdaq GEMX (H),1026724,140882,193112598.000000,452,143,2288684.000000,1027176,141025,195401282.000000
2023-09-18,Nasdaq ISE (I),1689492,194320,521013548.000000,15186,6413,70545393.000000,1704678,200733,591558941.000000
2023-09-18,Nasdaq MRX (J),611203,88492,150288496.000000,0,0,0.000000,611203,88492,150288496.000000
2023-09-18,MIAX Options Exchange (M),1901912,294227,415772528.000000,25,1,14625.000000,1901937,294228,415787153.000000
2023-09-18,NYSE Arca Options (N),3586122,487195,911482192.000000,0,0,0.000000,3586122,487195,911482192.000000
2023-09-18,MIAX Pearl (P),1952360,226904,366227840.000000,0,0,0.000000,1952360,226904,366227840.000000
2023-09-18,NASDAQ Options Market (Q),1757381,257516,446458101.000000,0,0,0.000000,1757381,257516,446458101.000000
2023-09-18,Nasdaq BX Options (T),1261079,172060,242021558.000000,0,0,0.000000,1261079,172060,242021558.000000
2023-09-18,Cboe C2 Options Exchange (W),1429904,171305,257607401.000000,9355,2779,12304707.000000,1439259,174084,269912108.000000
2023-09-18,Nasdaq PHLX (X),3351973,253989,1143000792.000000,17759,7582,79086067.000000,3369732,261571,1222086859.000000
2023-09-18,Cboe BZX Options Exchange (Z),1630812,223199,374188488.000000,1093,308,2189533.000000,1631905,223507,376378021.000000
2023-09-15,NYSE American Options (A),3065155,294628,624962375.000000,0,0,0.000000,3065155,294628,624962375.000000
2023-09-15,BOX Options (B),2900508,300397,912299414.000000,0,0,0.000000,2900508,300397,912299414.000000
2023-09-15,Cboe Options Exchange (C),4218802,590887,1219316000.000000,4893472,643086,8080019793.000000,9112274,1233973,9299335793.000000
2023-09-15,MIAX Emerald (D),1032977,177378,214964262.000000,0,0,0.000000,1032977,177378,214964262.000000
2023-09-15,Cboe EDGX Options Exchange (E),2791473,412539,470704316.000000,0,0,0.000000,2791473,412539,470704316.000000
2023-09-15,Nasdaq GEMX (H),1385399,177852,238048868.000000,2364,811,50799245.000000,1387763,178663,288848113.000000
2023-09-15,Nasdaq ISE (I),2600765,308113,883408525.000000,19040,7459,158533464.000000,2619805,315572,1041941989.000000
2023-09-15,Nasdaq MRX (J),916203,114067,184812260.000000,0,0,0.000000,916203,114067,184812260.000000
2023-09-15,MIAX Options Exchange (M),3099050,412022,625612381.000000,3,3,23.000000,3099053,412025,625612404.000000
2023-09-15,NYSE Arca Options (N),5331297,645662,1196549327.000000,0,0,0.000000,5331297,645662,1196549327.000000
2023-09-15,MIAX Pearl (P),2773956,298373,465245848.000000,0,0,0.000000,2773956,298373,465245848.000000
2023-09-15,NASDAQ Options Market (Q),2445873,351052,543804843.000000,0,0,0.000000,2445873,351052,543804843.000000
2023-09-15,Nasdaq BX Options (T),1694023,200917,367972269.000000,0,0,0.000000,1694023,200917,367972269.000000
2023-09-15,Cboe C2 Options Exchange (W),2084274,240292,406984739.000000,12776,3079,20700051.000000,2097050,243371,427684790.000000
2023-09-15,Nasdaq PHLX (X),4757315,300852,1484305584.000000,21676,7085,321843339.000000,4778991,307937,1806148923.000000
2023-09-15,Cboe BZX Options Exchange (Z),2521457,307453,515440975.000000,2661,442,7907670.000000,2524118,307895,523348645.000000
2023-09-14,NYSE American Options (A),3067873,251380,571849304.000000,0,0,0.000000,3067873,251380,571849304.000000
2023-09-14,BOX Options (B),3004885,272839,2073703626.000000,0,0,0.000000,3004885,272839,2073703626.000000
2023-09-14,Cboe Options Exchange (C),4004658,515726,1454027250.000000,3745793,572211,5456269334.000000,7750451,1087937,6910296584.000000
2023-09-14,MIAX Emerald (D),973304,156592,192451169.000000,0,0,0.000000,973304,156592,192451169.000000
2023-09-14,Cboe EDGX Options Exchange (E),2528430,371762,443726519.000000,0,0,0.000000,2528430,371762,443726519.000000
2023-09-14,Nasdaq GEMX (H),1204830,154467,231968625.000000,2531,805,123466588.000000,1207361,155272,355435213.000000
2023-09-14,Nasdaq ISE (I),2162848,253177,866593602.000000,23074,9868,436408604.000000,2185922,263045,1303002206.000000
2023-09-14,Nasdaq MRX (J),729559,97765,146046544.000000,0,0,0.000000,729559,97765,146046544.000000
2023-09-14,MIAX Options Exchange (M),2375598,350630,481896828.000000,0,0,0.000000,2375598,350630,481896828.000000
2023-09-14,NYSE Arca Options (N),4700671,576157,1367138549.000000,0,0,0.000000,4700671,576157,1367138549.000000
2023-09-14,MIAX Pearl (P),2322020,258742,392694890.000000,0,0,0.000000,2322020,258742,392694890.000000
2023-09-14,NASDAQ Options Market (Q),2095784,297283,507083714.000000,0,0,0.000000,2095784,297283,507083714.000000
2023-09-14,Nasdaq BX Options (T),1501151,183800,233676052.000000,0,0,0.000000,1501151,183800,233676052.000000
2023-09-14,Cboe C2 Options Exchange (W),1875652,208945,353936263.000000,9538,3020,12887545.000000,1885190,211965,366823808.000000
2023-09-14,Nasdaq PHLX (X),4931900,268228,2522835424.000000,27897,10277,341979849.000000,4959797,278505,2864815273.000000
2023-09-14,Cboe BZX Options Exchange (Z),2165902,274216,457668141.000000,6405,980,13180472.000000,2172307,275196,470848613.000000
2023-09-13,NYSE American Options (A),3455673,251197,794432622.000000,0,0,0.000000,3455673,251197,794432622.000000
2023-09-13,BOX Options (B),3595723,264166,3038331346.000000,0,0,0.000000,3595723,264166,3038331346.000000
2023-09-13,Cboe Options Exchange (C),4219015,480460,2134357377.000000,4121807,569620,7591187898.000000,8340822,1050080,9725545275.000000
2023-09-13,MIAX Emerald (D),885888,148952,182183219.000000,0,0,0.000000,885888,148952,182183219.000000
2023-09-13,Cboe EDGX Options Exchange (E),2274233,348548,377191658.000000,0,0,0.000000,2274233,348548,377191658.000000
2023-09-13,Nasdaq GEMX (H),1093561,145642,207511995.000000,1258,611,35699149.000000,1094819,146253,243211144.000000
2023-09-13,Nasdaq ISE (I),1852853,227957,603508197.000000,25525,9351,230350765.500000,1878378,237308,833858962.500000
2023-09-13,Nasdaq MRX (J),721614,91995,142699669.000000,0,0,0.000000,721614,91995,142699669.000000
2023-09-13,MIAX Options Exchange (M),2183542,326666,452428577.000000,0,0,0.000000,2183542,326666,452428577.000000
2023-09-13,NYSE Arca Options (N),4598056,552393,1030888833.000000,0,0,0.000000,4598056,552393,1030888833.000000
2023-09-13,MIAX Pearl (P),2187316,251623,424960009.000000,0,0,0.000000,2187316,251623,424960009.000000
2023-09-13,NASDAQ Options Market (Q),1902349,278447,488729180.000000,0,0,0.000000,1902349,278447,488729180.000000
2023-09-13,Nasdaq BX Options (T),1436576,194322,273801628.000000,0,0,0.000000,1436576,194322,273801628.000000
2023-09-13,Cboe C2 Options Exchange (W),1537589,172419,258377798.000000,11586,3634,18014503.000000,1549175,176053,276392301.000000
2023-09-13,Nasdaq PHLX (X),6536768,248889,5500325447.000000,25760,10506,115184317.000000,6562528,259395,5615509764.000000
2023-09-13,Cboe BZX Options Exchange (Z),2015760,260990,430712250.000000,2753,318,4706332.000000,2018513,261308,435418582.000000
2023-09-12,NYSE American Options (A),3107351,273431,710907955.000000,0,0,0.000000,3107351,273431,710907955.000000
2023-09-12,BOX Options (B),2453808,276769,1355633888.000000,0,0,0.000000,2453808,276769,1355633888.000000
2023-09-12,Cboe Options Exchange (C),3514417,463289,1285156983.000000,3165567,564966,7366873753.000000,6679984,1028255,8652030736.000000
2023-09-12,MIAX Emerald (D),865780,146639,183167210.000000,0,0,0.000000,865780,146639,183167210.000000
2023-09-12,Cboe EDGX Options Exchange (E),2229237,354623,377834308.000000,0,0,0.000000,2229237,354623,377834308.000000
2023-09-12,Nasdaq GEMX (H),1096718,150448,220373061.000000,836,441,12257273.000000,1097554,150889,232630334.000000
2023-09-12,Nasdaq ISE (I),1962295,227997,646227873.000000,25210,8981,334193995.000000,1987505,236978,980421868.000000
2023-09-12,Nasdaq MRX (J),645458,90865,128639872.000000,0,0,0.000000,645458,90865,128639872.000000
2023-09-12,MIAX Options Exchange (M),2082663,326939,471111162.000000,0,0,0.000000,2082663,326939,471111162.000000
2023-09-12,NYSE Arca Options (N),4184205,530331,1073252220.000000,0,0,0.000000,4184205,530331,1073252220.000000
2023-09-12,MIAX Pearl (P),2195818,259895,459631817.000000,0,0,0.000000,2195818,259895,459631817.000000
2023-09-12,NASDAQ Options Market (Q),1920817,290343,515860295.000000,0,0,0.000000,1920817,290343,515860295.000000
2023-09-12,Nasdaq BX Options (T),1458081,199619,344319933.000000,0,0,0.000000,1458081,199619,344319933.000000
2023-09-12,Cboe C2 Options Exchange (W),1491119,176671,249681816.000000,7036,1852,14454261.000000,1498155,178523,264136077.000000
2023-09-12,Nasdaq PHLX (X),4151221,243098,1511905497.000000,23176,9491,96066072.000000,4174397,252589,1607971569.000000
2023-09-12,Cboe BZX Options Exchange (Z),2120192,294081,482043922.000000,1884,320,6032025.000000,2122076,294401,488075947.000000
2023-09-11,NYSE American Options (A),2694356,286643,668926273.000000,0,0,0.000000,2694356,286643,668926273.000000
2023-09-11,BOX Options (B),2537891,285670,1639049246.000000,0,0,0.000000,2537891,285670,1639049246.000000
2023-09-11,Cboe Options Exchange (C),3742152,513418,1471123175.000000,3144749,523467,4320903206.000000,6886901,1036885,5792026381.000000
2023-09-11,MIAX Emerald (D),895970,157430,236682196.000000,0,0,0.000000,895970,157430,236682196.000000
2023-09-11,Cboe EDGX Options Exchange (E),2300757,369832,464507705.000000,0,0,0.000000,2300757,369832,464507705.000000
2023-09-11,Nasdaq GEMX (H),814797,108332,175651701.000000,1735,278,8946520.000000,816532,108610,184598221.000000
2023-09-11,Nasdaq ISE (I),2068124,246614,791234244.000000,22223,9149,127351323.000000,2090347,255763,918585567.000000
2023-09-11,Nasdaq MRX (J),712555,103512,166473629.000000,0,0,0.000000,712555,103512,166473629.000000
2023-09-11,MIAX Options Exchange (M),2565888,388164,654749200.000000,0,0,0.000000,2565888,388164,654749200.000000
2023-09-11,NYSE Arca Options (N),3942247,533467,1215468134.000000,0,0,0.000000,3942247,533467,1215468134.000000
2023-09-11,MIAX Pearl (P),2148356,245092,465281200.000000,0,0,0.000000,2148356,245092,465281200.000000
2023-09-11,NASDAQ Options Market (Q),1921902,294382,568351821.000000,0,0,0.000000,1921902,294382,568351821.000000
2023-09-11,Nasdaq BX Options (T),1381172,183231,297742208.000000,0,0,0.000000,1381172,183231,297742208.000000
2023-09-11,Cboe C2 Options Exchange (W),1625238,191979,300505293.000000,9883,2649,9323431.000000,1635121,194628,309828724.000000
2023-09-11,Nasdaq PHLX (X),4037832,269455,1850503035.000000,22962,9953,202616175.000000,4060794,279408,2053119210.000000
2023-09-11,Cboe BZX Options Exchange (Z),2089610,286032,534158252.000000,1560,296,1093955.000000,2091170,286328,535252207.000000
2023-09-08,NYSE American Options (A),2547066,248883,518813709.000000,0,0,0.000000,2547066,248883,518813709.000000
2023-09-08,BOX Options (B),3196665,316538,1482909227.000000,0,0,0.000000,3196665,316538,1482909227.000000
2023-09-08,Cboe Options Exchange (C),4054256,551215,1364483101.000000,3298799,558643,5289681783.000000,7353055,1109858,6654164884.000000
2023-09-08,MIAX Emerald (D),1039792,165643,187052533.000000,0,0,0.000000,1039792,165643,187052533.000000
2023-09-08,Cboe EDGX Options Exchange (E),2302192,343039,342236462.000000,0,0,0.000000,2302192,343039,342236462.000000
2023-09-08,Nasdaq GEMX (H),1295657,160131,208833878.000000,1085,293,2677158.000000,1296742,160424,211511036.000000
2023-09-08,Nasdaq ISE (I),2147999,261741,678675254.000000,20403,8732,93399177.000000,2168402,270473,772074431.000000
2023-09-08,Nasdaq MRX (J),803378,104209,129471558.000000,0,0,0.000000,803378,104209,129471558.000000
2023-09-08,MIAX Options Exchange (M),2412122,360099,431009844.000000,1,1,250.000000,2412123,360100,431010094.000000
2023-09-08,NYSE Arca Options (N),4265653,545361,1058147813.000000,0,0,0.000000,4265653,545361,1058147813.000000
2023-09-08,MIAX Pearl (P),2504886,273217,410500146.000000,0,0,0.000000,2504886,273217,410500146.000000
2023-09-08,NASDAQ Options Market (Q),2153876,319004,490777645.000000,0,0,0.000000,2153876,319004,490777645.000000
2023-09-08,Nasdaq BX Options (T),1639959,211780,326951079.000000,0,0,0.000000,1639959,211780,326951079.000000
2023-09-08,Cboe C2 Options Exchange (W),1735242,201493,267494186.000000,10117,2834,18280195.000000,1745359,204327,285774381.000000
2023-09-08,Nasdaq PHLX (X),4141129,285449,1645729360.000000,21323,9703,240386316.000000,4162452,295152,1886115676.000000
2023-09-08,Cboe BZX Options Exchange (Z),2396698,304251,450177605.000000,1103,205,694789.000000,2397801,304456,450872394.000000
2023-09-07,NYSE American Options (A),2788503,246819,682901169.000000,0,0,0.000000,2788503,246819,682901169.000000
2023-09-07,BOX Options (B),3090232,299446,1899655086.000000,0,0,0.000000,3090232,299446,1899655086.000000
2023-09-07,Cboe Options Exchange (C),4072911,536830,1402840535.000000,3382704,567249,4637315961.000000,7455615,1104079,6040156496.000000
2023-09-07,MIAX Emerald (D),995912,178878,224805427.000000,0,0,0.000000,995912,178878,224805427.000000
2023-09-07,Cboe EDGX Options Exchange (E),2392889,354475,422869247.000000,0,0,0.000000,2392889,354475,422869247.000000
2023-09-07,Nasdaq GEMX (H),1215929,162554,247635457.000000,902,360,11816579.000000,1216831,162914,259452036.000000
2023-09-07,Nasdaq ISE (I),2130750,259618,675061547.000000,21143,8629,133909962.000000,2151893,268247,808971509.000000
2023-09-07,Nasdaq MRX (J),658565,86158,115304991.000000,0,0,0.000000,658565,86158,115304991.000000
2023-09-07,MIAX Options Exchange (M),2327136,361079,463345652.000000,0,0,0.000000,2327136,361079,463345652.000000
2023-09-07,NYSE Arca Options (N),4679708,574502,1138294648.000000,0,0,0.000000,4679708,574502,1138294648.000000
2023-09-07,MIAX Pearl (P),2458410,285606,525114602.000000,0,0,0.000000,2458410,285606,525114602.000000
2023-09-07,NASDAQ Options Market (Q),2268443,328817,576901862.000000,0,0,0.000000,2268443,328817,576901862.000000
2023-09-07,Nasdaq BX Options (T),1664021,216913,349329394.000000,0,0,0.000000,1664021,216913,349329394.000000
2023-09-07,Cboe C2 Options Exchange (W),1654047,203950,271985216.000000,9253,3138,22401456.000000,1663300,207088,294386672.000000
2023-09-07,Nasdaq PHLX (X),4483864,284700,1927643567.000000,21224,10041,188468153.000000,4505088,294741,2116111720.000000
2023-09-07,Cboe BZX Options Exchange (Z),2037225,273127,470968747.000000,4569,893,13630669.000000,2041794,274020,484599416.000000
2023-09-06,NYSE American Options (A),2477790,230824,704499339.000000,0,0,0.000000,2477790,230824,704499339.000000
2023-09-06,BOX Options (B),2833954,285901,1750098726.000000,0,0,0.000000,2833954,285901,1750098726.000000
2023-09-06,Cboe Options Exchange (C),4204726,531539,1920924336.000000,3601130,635147,5178936526.000000,7805856,1166686,7099860862.000000
2023-09-06,MIAX Emerald (D),966622,169510,201278241.000000,0,0,0.000000,966622,169510,201278241.000000
2023-09-06,Cboe EDGX Options Exchange (E),2333449,339302,374373168.000000,0,0,0.000000,2333449,339302,374373168.000000
2023-09-06,Nasdaq GEMX (H),1098907,148536,216371744.000000,1881,396,11000288.000000,1100788,148932,227372032.000000
2023-09-06,Nasdaq ISE (I),2053195,262740,618904180.000000,23624,8666,93448954.000000,2076819,271406,712353134.000000
2023-09-06,Nasdaq MRX (J),636877,92851,148240120.000000,0,0,0.000000,636877,92851,148240120.000000
2023-09-06,MIAX Options Exchange (M),2138113,320643,425310779.000000,2,2,244.000000,2138115,320645,425311023.000000
2023-09-06,NYSE Arca Options (N),4586853,574726,1071217435.000000,0,0,0.000000,4586853,574726,1071217435.000000
2023-09-06,MIAX Pearl (P),2373434,274128,459631568.000000,0,0,0.000000,2373434,274128,459631568.000000
2023-09-06,NASDAQ Options Market (Q),2023976,317755,529013560.000000,0,0,0.000000,2023976,317755,529013560.000000
2023-09-06,Nasdaq BX Options (T),1686820,210884,328690541.000000,0,0,0.000000,1686820,210884,328690541.000000
2023-09-06,Cboe C2 Options Exchange (W),1536520,180416,266244267.000000,10982,3382,16628500.000000,1547502,183798,282872767.000000
2023-09-06,Nasdaq PHLX (X),5194196,260493,4827035411.000000,24144,9693,153547891.000000,5218340,270186,4980583302.000000
2023-09-06,Cboe BZX Options Exchange (Z),1688282,226061,377433215.000000,4269,401,5105740.000000,1692551,226462,382538955.000000
2023-09-05,NYSE American Options (A),2259844,214273,497223221.000000,0,0,0.000000,2259844,214273,497223221.000000
2023-09-05,BOX Options (B),2472049,272039,705821943.000000,0,0,0.000000,2472049,272039,705821943.000000
2023-09-05,Cboe Options Exchange (C),3323934,491611,1207764915.000000,2869536,504685,4449665000.000000,6193470,996296,5657429915.000000
2023-09-05,MIAX Emerald (D),846836,150131,177463425.000000,0,0,0.000000,846836,150131,177463425.000000
2023-09-05,Cboe EDGX Options Exchange (E),1982842,303240,336239495.000000,0,0,0.000000,1982842,303240,336239495.000000
2023-09-05,Nasdaq GEMX (H),967205,137398,180104823.000000,1797,355,22010265.000000,969002,137753,202115088.000000
2023-09-05,Nasdaq ISE (I),1907301,241965,733952189.000000,18515,7002,123606070.000000,1925816,248967,857558259.000000
2023-09-05,Nasdaq MRX (J),675864,89850,131633093.000000,0,0,0.000000,675864,89850,131633093.000000
2023-09-05,MIAX Options Exchange (M),1841499,297877,406009110.000000,1,1,142.000000,1841500,297878,406009252.000000
2023-09-05,NYSE Arca Options (N),3967648,537864,1075798383.000000,0,0,0.000000,3967648,537864,1075798383.000000
2023-09-05,MIAX Pearl (P),2052133,235767,417205508.000000,0,0,0.000000,2052133,235767,417205508.000000
2023-09-05,NASDAQ Options Market (Q),1837193,295057,491641396.000000,0,0,0.000000,1837193,295057,491641396.000000
2023-09-05,Nasdaq BX Options (T),1432046,192021,307624299.000000,0,0,0.000000,1432046,192021,307624299.000000
2023-09-05,Cboe C2 Options Exchange (W),1402320,168065,247549372.000000,13587,4002,15273400.000000,1415907,172067,262822772.000000
2023-09-05,Nasdaq PHLX (X),3579105,263488,1363184485.000000,22048,8567,131706103.000000,3601153,272055,1494890588.000000
2023-09-05,Cboe BZX Options Exchange (Z),1548313,212108,359382173.000000,1733,270,2581305.000000,1550046,212378,361963478.000000
2023-09-01,NYSE American Options (A),2318090,251756,431982579.000000,0,0,0.000000,2318090,251756,431982579.000000
2023-09-01,BOX Options (B),2485782,292091,1039601821.000000,0,0,0.000000,2485782,292091,1039601821.000000
2023-09-01,Cboe Options Exchange (C),4216278,602440,1365411285.000000,3483047,573342,5089545909.000000,7699325,1175782,6454957194.000000
2023-09-01,MIAX Emerald (D),1209638,192740,249427741.000000,0,0,0.000000,1209638,192740,249427741.000000
2023-09-01,Cboe EDGX Options Exchange (E),2440980,355021,386170362.000000,0,0,0.000000,2440980,355021,386170362.000000
2023-09-01,Nasdaq GEMX (H),1283448,161198,224386477.000000,713,213,8257478.000000,1284161,161411,232643955.000000
2023-09-01,Nasdaq ISE (I),2496999,313072,841067621.000000,21755,7769,100882857.500000,2518754,320841,941950478.500000
2023-09-01,Nasdaq MRX (J),869232,112708,145936432.000000,0,0,0.000000,869232,112708,145936432.000000
2023-09-01,MIAX Options Exchange (M),2512855,387427,503069488.000000,0,0,0.000000,2512855,387427,503069488.000000
2023-09-01,NYSE Arca Options (N),5331407,623331,1168991940.000000,0,0,0.000000,5331407,623331,1168991940.000000
2023-09-01,MIAX Pearl (P),2601818,286640,463070234.000000,0,0,0.000000,2601818,286640,463070234.000000
2023-09-01,NASDAQ Options Market (Q),2404468,361957,570355241.000000,0,0,0.000000,2404468,361957,570355241.000000
2023-09-01,Nasdaq BX Options (T),1710513,231691,469696088.000000,0,0,0.000000,1710513,231691,469696088.000000
2023-09-01,Cboe C2 Options Exchange (W),1886251,220824,396624866.000000,10410,3227,10334784.000000,1896661,224051,406959650.000000
2023-09-01,Nasdaq PHLX (X),4328772,299700,1500018426.000000,20414,8507,112542922.000000,4349186,308207,1612561348.000000
2023-09-01,Cboe BZX Options Exchange (Z),1986990,258788,445008309.000000,1409,250,2194895.000000,1988399,259038,447203204.000000
2023-08-31,NYSE American Options (A),2620668,232259,2017416945.000000,0,0,0.000000,2620668,232259,2017416945.000000
2023-08-31,BOX Options (B),2477073,280075,1140451192.000000,0,0,0.000000,2477073,280075,1140451192.000000
2023-08-31,Cboe Options Exchange (C),4275594,576237,1339098824.000000,3597610,570213,7590830548.000000,7873204,1146450,8929929372.000000
2023-08-31,MIAX Emerald (D),988204,173206,212511291.000000,0,0,0.000000,988204,173206,212511291.000000
2023-08-31,Cboe EDGX Options Exchange (E),2234591,318417,354512157.000000,0,0,0.000000,2234591,318417,354512157.000000
2023-08-31,Nasdaq GEMX (H),1083243,145919,200836982.000000,629,241,8371155.000000,1083872,146160,209208137.000000
2023-08-31,Nasdaq ISE (I),1990790,258839,634641192.500000,26413,8703,151835021.000000,2017203,267542,786476213.500000
2023-08-31,Nasdaq MRX (J),702626,95470,134804568.000000,0,0,0.000000,702626,95470,134804568.000000
2023-08-31,MIAX Options Exchange (M),2212558,347125,485080003.000000,1,1,157.000000,2212559,347126,485080160.000000
2023-08-31,NYSE Arca Options (N),4351759,588560,1104987727.000000,0,0,0.000000,4351759,588560,1104987727.000000
2023-08-31,MIAX Pearl (P),2279726,259744,429849008.000000,0,0,0.000000,2279726,259744,429849008.000000
2023-08-31,NASDAQ Options Market (Q),2070617,310779,507639556.000000,0,0,0.000000,2070617,310779,507639556.000000
2023-08-31,Nasdaq BX Options (T),1508930,215368,287188601.000000,0,0,0.000000,1508930,215368,287188601.000000
2023-08-31,Cboe C2 Options Exchange (W),1505175,186537,290761636.000000,7330,2590,8529966.000000,1512505,189127,299291602.000000
2023-08-31,Nasdaq PHLX (X),3979527,244199,1406156017.000000,22592,9020,122138855.000000,4002119,253219,1528294872.000000
2023-08-31,Cboe BZX Options Exchange (Z),1414486,182990,343422208.000000,2389,534,5862904.000000,1416875,183524,349285112.000000